840,0,1,1,1,853,853,0.57143
480,0,1,1,1,508,508,0.57143
240,-52,0,0,4,231,283,0
0,83,0,0,4,46,-37,0
240,22,0,0,1,252,230,0.42857
840,0,1,0,2,820,820,0.28571
240,0,1,1,1,236,236,0.57143
240,0,1,1,1,194,194,0.57143
0,-51,0,0,4,4,55,0
0,0,1,1,1,-44,-44,0.57143
480,-40,0,0,2,461,501,0.28571
480,12,0,0,2,499,487,0.28571
840,-21,0,0,2,828,849,0.28571
840,48,0,0,2,869,821,0.28571
480,0,1,0,1,474,474,0.42857
0,40,0,0,4,20,-20,0
240,0,1,0,3,240,240,0.14286
0,-28,0,0,4,-28,0,0
480,-18,0,0,1,485,503,0.42857
840,0,1,0,2,833,833,0.28571
840,39,0,0,2,871,832,0.28571
240,-32,0,0,3,198,230,0.14286
480,0,1,1,1,455,455,0.57143
0,51,0,0,4,45,-6,0
480,16,0,1,3,496,480,0.85714
840,-28,0,1,2,817,845,0.71429
0,-37,0,0,4,-27,10,0
840,0,1,1,1,840,840,0.57143
840,0,1,0,2,850,850,0.28571
0,67,0,0,4,33,-34,0
840,-93,0,1,2,833,926,0.71429
0,0,1,1,4,-7,-7,1
480,-10,0,1,4,452,462,1
0,0,1,1,4,-24,-24,1
0,0,1,1,4,-37,-37,1
0,0,1,1,4,37,37,1
480,0,1,1,4,476,476,1
240,0,1,1,4,250,250,1
840,37,0,0,2,860,823,0.28571
0,15,0,0,2,10,-5,0.28571
0,39,0,0,3,13,-26,0.14286
240,-22,0,0,3,218,240,0.14286
840,0,1,1,2,796,796,0.71429
840,0,1,1,2,820,820,0.71429
0,0,1,1,2,-5,-5,0.71429
480,0,1,1,3,468,468,0.85714
0,-16,0,0,2,15,31,0.28571
840,24,0,1,3,856,832,0.85714
840,-11,0,1,3,850,861,0.85714
240,0,1,1,2,244,244,0.71429
840,7,0,1,3,854,847,0.85714
240,-90,0,0,2,185,275,0.28571
0,0,1,1,3,-10,-10,0.85714
480,11,0,1,3,477,466,0.85714
480,0,1,1,3,502,502,0.85714
240,27,0,0,2,243,216,0.28571
0,0,1,0,1,49,49,0.42857
0,49,0,0,3,3,-46,0.14286
0,0,1,0,2,2,2,0.28571
480,0,1,1,1,514,514,0.57143
240,0,1,1,1,231,231,0.57143
240,0,1,1,1,188,188,0.57143
0,15,0,0,3,-23,-38,0.14286
480,13,0,1,2,505,492,0.71429
240,0,1,1,2,255,255,0.71429
240,31,0,1,2,245,214,0.71429
480,0,1,1,2,477,477,0.71429
240,0,1,1,3,249,249,0.85714
0,0,1,1,3,-5,-5,0.85714
240,0,1,1,2,264,264,0.71429
0,-36,0,0,4,-19,17,0
840,0,1,0,2,898,898,0.28571
240,0,1,0,1,244,244,0.42857
480,-6,0,0,2,467,473,0.28571
0,-8,0,0,1,-13,-5,0.42857
840,-55,0,0,2,801,856,0.28571
240,0,1,0,3,234,234,0.14286
240,39,0,0,3,230,191,0.14286
480,0,1,1,2,434,434,0.71429
240,4,0,1,2,221,217,0.71429
0,0,1,1,4,-39,-39,1
0,-32,0,0,3,-14,18,0.14286
480,0,1,1,3,505,505,0.85714
480,-24,0,1,3,454,478,0.85714
840,-32,0,0,3,826,858,0.14286
840,14,0,1,2,869,855,0.71429
840,0,1,1,2,829,829,0.71429
0,-22,0,0,3,-9,13,0.14286
0,0,1,1,3,22,22,0.85714
480,0,1,1,2,468,468,0.71429
240,-16,0,1,3,222,238,0.85714
840,0,1,0,1,880,880,0.42857
240,0,1,1,3,229,229,0.85714
480,-7,0,1,3,457,464,0.85714
480,-17,0,1,3,478,495,0.85714
240,0,1,1,2,220,220,0.71429
480,0,1,1,2,471,471,0.71429
240,0,1,1,2,222,222,0.71429
480,47,0,1,2,514,467,0.71429
480,0,1,1,2,494,494,0.71429
240,0,1,1,2,232,232,0.71429
0,57,0,0,4,27,-30,0
840,39,0,1,2,898,859,0.71429
480,46,0,0,2,523,477,0.28571
240,0,1,0,3,262,262,0.14286
240,0,1,0,2,293,293,0.28571
240,0,1,0,1,225,225,0.42857
240,0,1,1,2,267,267,0.71429
0,47,0,0,2,20,-27,0.28571
840,0,1,0,3,848,848,0.14286
240,0,1,1,2,223,223,0.71429
0,0,1,1,3,0,0,0.85714
240,15,0,1,3,233,218,0.85714
0,0,1,1,3,32,32,0.85714
480,23,0,1,3,496,473,0.85714
840,31,0,1,2,848,817,0.71429
480,0,1,1,2,464,464,0.71429
480,35,0,1,2,514,479,0.71429
0,20,0,0,3,17,-3,0.14286
240,33,0,0,2,254,221,0.28571
0,28,0,0,2,6,-22,0.28571
240,0,1,0,3,231,231,0.14286
480,31,0,0,3,519,488,0.14286
480,50,0,0,2,497,447,0.28571
0,7,0,1,1,11,4,0.57143
240,0,1,0,3,266,266,0.14286
0,0,1,1,1,14,14,0.57143
480,0,1,1,1,495,495,0.57143
0,0,1,1,1,19,19,0.57143
480,41,0,0,2,496,455,0.28571
840,0,1,0,2,852,852,0.28571
840,-32,0,0,3,844,876,0.14286
840,-14,0,0,3,845,859,0.14286
480,33,0,0,3,532,499,0.14286
0,23,0,0,3,22,-1,0.14286
240,-15,0,0,3,244,259,0.14286
240,0,1,0,3,235,235,0.14286
840,0,1,0,3,851,851,0.14286
840,0,1,0,3,817,817,0.14286
0,0,1,1,1,1,1,0.57143
240,0,1,1,2,220,220,0.71429
0,0,1,1,2,13,13,0.71429
0,0,1,1,2,29,29,0.71429
240,0,1,1,2,234,234,0.71429
240,-35,0,0,2,253,288,0.28571
840,0,1,0,2,819,819,0.28571
0,0,1,1,2,37,37,0.71429
840,63,0,0,2,849,786,0.28571
840,0,1,0,2,874,874,0.28571
240,6,0,1,2,266,260,0.71429
840,-11,0,0,2,836,847,0.28571
0,0,1,1,2,29,29,0.71429
480,-57,0,0,2,446,503,0.28571
840,-21,0,0,1,821,842,0.42857
240,11,0,1,2,244,233,0.71429
240,-8,0,1,2,242,250,0.71429
0,18,0,0,2,11,-7,0.28571
0,36,0,0,2,17,-19,0.28571
480,0,1,1,2,480,480,0.71429
0,0,1,1,2,7,7,0.71429
840,0,1,1,3,825,825,0.85714
0,-34,0,0,4,-18,16,0
480,-15,0,1,3,471,486,0.85714
240,0,1,1,1,237,237,0.57143
840,-22,0,0,2,819,841,0.28571
840,0,1,0,2,823,823,0.28571
0,0,1,1,3,10,10,0.85714
840,0,1,1,3,862,862,0.85714
0,10,0,0,3,20,10,0.14286
240,0,1,1,3,206,206,0.85714
840,0,1,1,3,788,788,0.85714
0,0,1,1,3,27,27,0.85714
240,0,1,1,4,271,271,1
480,0,1,1,4,513,513,1
840,-10,0,1,4,837,847,1
840,0,1,1,1,846,846,0.57143
480,0,1,1,2,492,492,0.71429
480,-8,0,1,2,492,500,0.71429
240,38,0,0,3,243,205,0.14286
240,10,0,1,2,244,234,0.71429
240,0,1,1,2,276,276,0.71429
480,0,1,1,2,481,481,0.71429
0,-11,0,0,3,7,18,0.14286
840,0,1,1,2,826,826,0.71429
240,0,1,1,2,273,273,0.71429
480,-12,0,1,3,469,481,0.85714
840,0,1,1,3,835,835,0.85714
480,-14,0,1,3,444,458,0.85714
480,-1,0,1,3,465,466,0.85714
480,-2,0,1,3,474,476,0.85714
240,0,1,1,3,205,205,0.85714
480,0,1,1,3,489,489,0.85714
840,0,1,1,3,839,839,0.85714
0,-79,0,0,3,-16,63,0.14286
0,50,0,0,4,43,-7,0
240,0,1,1,3,245,245,0.85714
480,0,1,1,3,456,456,0.85714
480,0,1,1,3,473,473,0.85714
240,11,0,1,3,246,235,0.85714
480,0,1,1,3,493,493,0.85714
0,0,1,1,4,-52,-52,1
240,0,1,1,4,194,194,1
480,49,0,1,4,531,482,1
0,34,0,0,4,-19,-53,0
480,0,1,1,3,499,499,0.85714
240,0,1,1,3,241,241,0.85714
240,-26,0,0,4,232,258,0
240,-34,0,0,4,226,260,0
0,0,1,1,4,-21,-21,1
840,18,0,1,2,876,858,0.71429
480,-25,0,0,3,495,520,0.14286
240,4,0,0,3,236,232,0.14286
240,0,1,1,3,252,252,0.85714
840,41,0,1,2,878,837,0.71429
480,0,1,1,2,486,486,0.71429
240,-35,0,0,3,226,261,0.14286
0,-34,0,0,3,-24,10,0.14286
0,-17,0,0,3,-25,-8,0.14286
0,-23,0,0,3,4,27,0.14286
240,-6,0,0,3,230,236,0.14286
840,0,1,1,3,828,828,0.85714
840,0,1,0,3,841,841,0.14286
480,0,1,0,2,493,493,0.28571
480,0,1,1,2,514,514,0.71429
0,50,0,0,4,31,-19,0
240,0,1,1,2,231,231,0.71429
240,0,1,1,2,251,251,0.71429
480,-35,0,1,2,441,476,0.71429
0,92,0,0,4,64,-28,0
840,0,1,0,3,818,818,0.14286
840,34,0,1,2,863,829,0.71429
0,0,1,1,4,-22,-22,1
240,0,1,1,4,238,238,1
840,-11,0,0,2,828,839,0.28571
0,0,1,1,4,-28,-28,1
480,0,1,1,4,494,494,1
240,0,1,1,4,240,240,1
240,27,0,1,4,269,242,1
240,22,0,0,3,209,187,0.14286
480,-4,0,1,3,482,486,0.85714
840,0,1,1,3,814,814,0.85714
240,26,0,0,2,247,221,0.28571
240,19,0,0,2,249,230,0.28571
480,0,1,1,4,437,437,1
0,-35,0,0,4,-7,28,0
240,0,1,1,3,256,256,0.85714
480,8,0,1,3,458,450,0.85714
840,0,1,1,3,798,798,0.85714
480,5,0,1,3,471,466,0.85714
240,-1,0,1,4,224,225,1
840,0,1,0,2,856,856,0.28571
240,17,0,0,2,233,216,0.28571
840,-11,0,0,1,808,819,0.42857
480,0,1,0,2,466,466,0.28571
840,24,0,0,2,832,808,0.28571
840,0,1,0,2,823,823,0.28571
0,-76,0,0,4,9,85,0
240,-2,0,0,3,247,249,0.14286
0,11,0,0,2,29,18,0.28571
840,0,1,0,2,867,867,0.28571
480,0,1,1,3,469,469,0.85714
840,14,0,1,2,846,832,0.71429
240,0,1,1,4,262,262,1
240,-10,0,1,2,243,253,0.71429
840,0,1,1,3,832,832,0.85714
240,0,1,0,2,255,255,0.28571
240,0,1,0,1,261,261,0.42857
840,55,0,0,2,859,804,0.28571
480,0,1,0,2,497,497,0.28571
240,0,1,1,1,291,291,0.57143
840,-36,0,0,3,834,870,0.14286
0,0,1,1,4,-47,-47,1
840,-15,0,1,3,826,841,0.85714
240,10,0,1,4,241,231,1
840,-6,0,1,2,824,830,0.71429
840,8,0,0,2,847,839,0.28571
240,0,1,0,2,209,209,0.28571
0,0,1,1,4,-30,-30,1
240,0,1,0,2,216,216,0.28571
0,20,0,0,3,23,3,0.14286
840,5,0,0,2,841,836,0.28571
480,0,1,1,4,493,493,1
840,34,0,0,1,888,854,0.42857
240,8,0,1,3,214,206,0.85714
240,-4,0,0,2,228,232,0.28571
240,15,0,0,2,233,218,0.28571
0,19,0,0,2,-39,-58,0.28571
840,9,0,0,3,852,843,0.14286
0,0,1,1,4,11,11,1
840,-11,0,1,3,840,851,0.85714
840,-103,0,0,2,787,890,0.28571
840,-3,0,0,2,826,829,0.28571
0,0,1,1,4,32,32,1
840,-43,0,0,2,828,871,0.28571
480,8,0,1,4,474,466,1
240,0,1,1,4,271,271,1
0,0,1,1,4,-16,-16,1
240,0,1,1,4,260,260,1
480,0,1,1,4,454,454,1
240,0,1,1,4,218,218,1
0,9,0,0,3,-3,-12,0.14286
840,-69,0,0,2,800,869,0.28571
840,-11,0,0,2,833,844,0.28571
480,0,1,0,2,490,490,0.28571
0,0,1,1,4,-12,-12,1
840,-51,0,0,3,814,865,0.14286
0,0,1,1,4,3,3,1
840,0,1,0,2,877,877,0.28571
480,0,1,1,4,475,475,1
240,0,1,1,4,233,233,1
0,53,0,0,4,44,-9,0
840,0,1,0,1,813,813,0.42857
240,0,1,0,2,206,206,0.28571
0,0,1,1,4,-5,-5,1
840,4,0,1,4,823,819,1
480,0,1,1,1,527,527,0.57143
240,-17,0,1,2,229,246,0.71429
240,0,1,1,2,253,253,0.71429
480,0,1,1,2,452,452,0.71429
240,0,1,1,3,262,262,0.85714
240,-8,0,1,3,238,246,0.85714
840,51,0,0,4,882,831,0
480,24,0,0,2,514,490,0.28571
480,0,1,1,4,509,509,1
0,-17,0,0,4,12,29,0
840,0,1,1,2,838,838,0.71429
240,0,1,1,2,208,208,0.71429
480,0,1,1,2,484,484,0.71429
240,0,1,1,1,226,226,0.57143
480,37,0,0,2,489,452,0.28571
840,3,0,0,2,866,863,0.28571
480,0,1,0,2,512,512,0.28571
240,-7,0,1,3,198,205,0.85714
840,-74,0,0,2,811,885,0.28571
480,-24,0,1,3,472,496,0.85714
240,5,0,1,2,244,239,0.71429
480,0,1,1,2,472,472,0.71429
840,0,1,1,2,834,834,0.71429
480,3,0,1,2,470,467,0.71429
0,0,1,0,2,-9,-9,0.28571
840,0,1,0,2,806,806,0.28571
0,0,1,1,4,-21,-21,1
480,0,1,1,2,522,522,0.71429
480,0,1,1,3,483,483,0.85714
840,0,1,0,2,852,852,0.28571
0,0,1,1,4,45,45,1
0,12,0,0,1,12,0,0.42857
480,-28,0,0,3,461,489,0.14286
840,0,1,1,1,865,865,0.57143
840,0,1,1,1,884,884,0.57143
240,0,1,1,2,306,306,0.71429
840,0,1,0,2,852,852,0.28571
0,0,1,1,3,5,5,0.85714
480,-20,0,1,2,461,481,0.71429
240,0,1,1,2,291,291,0.71429
0,0,1,1,3,-6,-6,0.85714
480,-43,0,0,2,485,528,0.28571
480,0,1,0,1,467,467,0.42857
0,0,1,1,4,39,39,1
0,2,0,1,4,-15,-17,1
480,11,0,1,3,472,461,0.85714
840,-37,0,0,2,825,862,0.28571
0,0,1,1,4,-32,-32,1
480,-25,0,1,3,493,518,0.85714
0,0,1,1,2,10,10,0.71429
0,0,1,1,2,82,82,0.71429
240,0,1,0,1,242,242,0.42857
840,0,1,0,2,822,822,0.28571
240,-41,0,0,2,260,301,0.28571
480,0,1,0,1,486,486,0.42857
240,0,1,0,1,245,245,0.42857
840,0,1,0,1,826,826,0.42857
0,0,1,1,3,-62,-62,0.85714
240,-35,0,0,1,224,259,0.42857
840,9,0,1,1,849,840,0.57143
480,0,1,0,2,470,470,0.28571
480,0,1,0,1,490,490,0.42857
480,-30,0,0,1,465,495,0.42857
0,51,0,0,3,4,-47,0.14286
840,-31,0,0,3,851,882,0.14286
0,0,1,1,3,-15,-15,0.85714
840,0,1,1,3,833,833,0.85714
0,0,1,1,3,-33,-33,0.85714
480,0,1,1,4,462,462,1
480,0,1,1,3,488,488,0.85714
840,0,1,1,3,812,812,0.85714
240,0,1,1,4,229,229,1
0,0,1,1,4,-19,-19,1
840,15,0,1,4,870,855,1
240,46,0,0,2,255,209,0.28571
840,-16,0,0,2,845,861,0.28571
0,4,0,1,3,9,5,0.85714
840,-23,0,0,2,828,851,0.28571
480,0,1,0,2,449,449,0.28571
840,37,0,0,1,855,818,0.42857
480,0,1,0,1,518,518,0.42857
840,0,1,0,1,825,825,0.42857
240,0,1,1,3,242,242,0.85714
480,0,1,0,2,471,471,0.28571
480,0,1,0,2,479,479,0.28571
0,0,1,1,3,13,13,0.85714
0,0,1,1,3,-17,-17,0.85714
840,0,1,1,3,815,815,0.85714
0,2,0,1,4,26,24,1
840,-24,0,1,3,819,843,0.85714
0,-5,0,1,4,-28,-23,1
0,14,0,0,1,-33,-47,0.42857
0,-13,0,0,1,-2,11,0.42857
0,-4,0,0,1,-25,-21,0.42857
240,28,0,0,2,262,234,0.28571
480,0,1,1,2,484,484,0.71429
0,-13,0,0,1,3,16,0.42857
0,-3,0,1,2,-8,-5,0.71429
0,10,0,0,2,12,2,0.28571
0,0,1,0,1,15,15,0.42857
0,20,0,0,2,11,-9,0.28571
240,0,1,0,2,257,257,0.28571
0,0,1,0,2,42,42,0.28571
480,0,1,0,2,501,501,0.28571
840,26,0,0,2,844,818,0.28571
0,0,1,1,2,-50,-50,0.71429
240,0,1,1,2,237,237,0.71429
480,22,0,1,2,490,468,0.71429
240,10,0,1,2,281,271,0.71429
0,3,0,1,3,7,4,0.85714
480,61,0,0,2,505,444,0.28571
840,15,0,0,2,860,845,0.28571
240,57,0,0,2,276,219,0.28571
480,0,1,0,2,441,441,0.28571
0,26,0,0,2,10,-16,0.28571
480,0,1,0,2,466,466,0.28571
480,24,0,0,2,482,458,0.28571
480,-74,0,0,4,441,515,0
480,0,1,1,3,526,526,0.85714
480,43,0,0,2,499,456,0.28571
840,-49,0,0,3,848,897,0.14286
240,-5,0,0,2,240,245,0.28571
480,79,0,0,2,518,439,0.28571
480,0,1,1,3,465,465,0.85714
240,0,1,1,3,234,234,0.85714
240,27,0,0,2,263,236,0.28571
0,-23,0,0,4,-10,13,0
0,0,1,1,4,7,7,1
840,34,0,0,3,847,813,0.14286
0,-25,0,1,3,-10,15,0.85714
840,6,0,1,3,850,844,0.85714
840,0,1,0,2,853,853,0.28571
480,0,1,1,4,493,493,1
840,-51,0,0,2,844,895,0.28571
480,-15,0,1,4,424,439,1
480,-53,0,0,3,441,494,0.14286
480,42,0,0,2,499,457,0.28571
480,0,1,1,3,520,520,0.85714
240,-28,0,0,2,232,260,0.28571
0,0,1,1,4,1,1,1
480,0,1,0,2,436,436,0.28571
240,0,1,1,1,204,204,0.57143
0,-14,0,0,1,-7,7,0.42857
840,9,0,1,3,868,859,0.85714
240,7,0,1,3,253,246,0.85714
0,0,1,1,3,25,25,0.85714
240,41,0,0,2,239,198,0.28571
0,21,0,0,2,-5,-26,0.28571
240,16,0,1,3,235,219,0.85714
480,73,0,0,2,546,473,0.28571
0,-77,0,0,2,-44,33,0.28571
0,0,1,1,4,31,31,1
0,19,0,0,4,10,-9,0
480,92,0,1,2,512,420,0.71429
840,14,0,0,1,828,814,0.42857
480,-89,0,0,2,406,495,0.28571
840,0,1,1,2,791,791,0.71429
480,0,1,1,3,457,457,0.85714
840,0,1,1,3,843,843,0.85714
0,0,1,1,4,8,8,1
840,-37,0,0,1,816,853,0.42857
840,0,1,1,2,868,868,0.71429
240,0,1,1,3,188,188,0.85714
240,-21,0,0,1,205,226,0.42857
480,-10,0,1,3,473,483,0.85714
240,38,0,0,1,259,221,0.42857
480,-50,0,0,1,497,547,0.42857
240,-41,0,0,2,238,279,0.28571
840,-6,0,0,2,859,865,0.28571
0,0,1,1,3,11,11,0.85714
480,63,0,0,2,537,474,0.28571
840,-25,0,0,2,817,842,0.28571
840,0,1,1,3,886,886,0.85714
240,0,1,1,3,202,202,0.85714
480,-36,0,1,4,457,493,1
840,29,0,0,2,880,851,0.28571
840,0,1,0,1,830,830,0.42857
840,0,1,1,2,805,805,0.71429
0,45,0,0,3,16,-29,0.14286
240,0,1,1,3,234,234,0.85714
840,0,1,0,1,866,866,0.42857
240,0,1,1,3,233,233,0.85714
840,0,1,0,2,855,855,0.28571
0,0,1,1,3,-30,-30,0.85714
0,0,1,1,3,-32,-32,0.85714
480,0,1,1,3,486,486,0.85714
240,-1,0,1,4,234,235,1
840,0,1,0,2,852,852,0.28571
240,-1,0,1,3,229,230,0.85714
480,0,1,1,3,485,485,0.85714
840,-19,0,0,2,831,850,0.28571
240,0,1,0,1,239,239,0.42857
480,56,0,0,1,508,452,0.42857
840,-21,0,0,1,808,829,0.42857
240,0,1,1,1,250,250,0.57143
840,-15,0,0,1,857,872,0.42857
480,0,1,1,1,478,478,0.57143
840,0,1,1,1,817,817,0.57143
0,-22,0,0,2,-29,-7,0.28571
840,30,0,0,2,847,817,0.28571
0,-30,0,0,3,-13,17,0.14286
480,23,0,1,3,480,457,0.85714
480,0,1,1,3,498,498,0.85714
240,-2,0,1,3,220,222,0.85714
480,0,1,1,3,460,460,0.85714
840,20,0,1,3,854,834,0.85714
480,0,1,1,3,450,450,0.85714
240,-38,0,0,3,206,244,0.14286
840,-23,0,0,4,844,867,0
0,-10,0,1,4,-0,10,1
480,0,1,1,4,466,466,1
240,-55,0,0,4,217,272,0
240,14,0,0,2,239,225,0.28571
0,0,1,1,4,-13,-13,1
840,11,0,0,4,860,849,0
840,0,1,0,2,859,859,0.28571
0,-24,0,0,2,-14,10,0.28571
0,12,0,0,2,18,6,0.28571
840,1,0,1,3,835,834,0.85714
0,-45,0,0,4,-16,29,0
240,0,1,1,4,233,233,1
240,50,0,0,4,253,203,0
480,0,1,1,4,488,488,1
240,0,1,1,4,247,247,1
840,-46,0,0,3,822,868,0.14286
240,3,0,1,4,266,263,1
240,0,1,1,4,256,256,1
840,0,1,1,1,828,828,0.57143
0,38,0,0,4,9,-29,0
240,-33,0,0,4,251,284,0
480,0,1,1,4,460,460,1
0,-3,0,1,3,-12,-9,0.85714
0,0,1,1,4,34,34,1
840,0,1,0,3,839,839,0.14286
240,-5,0,1,4,203,208,1
480,-28,0,1,4,518,546,1
0,-3,0,1,4,10,13,1
480,-4,0,1,4,441,445,1
480,0,1,1,4,505,505,1
840,0,1,1,4,841,841,1
240,-28,0,1,4,211,239,1
840,0,1,0,2,842,842,0.28571
240,0,1,1,4,253,253,1
840,-20,0,1,4,821,841,1
0,-9,0,1,4,8,17,1
240,0,1,1,4,232,232,1
480,85,0,0,2,537,452,0.28571
480,0,1,1,4,509,509,1
480,39,0,1,3,490,451,0.85714
0,0,1,1,4,2,2,1
0,0,1,1,4,-10,-10,1
0,-29,0,0,4,-38,-9,0
480,0,1,1,2,441,441,0.71429
480,18,0,1,2,480,462,0.71429
840,0,1,1,2,845,845,0.71429
840,0,1,1,3,828,828,0.85714
480,-46,0,0,3,432,478,0.14286
240,-1,0,0,2,243,244,0.28571
840,0,1,0,3,856,856,0.14286
240,56,0,0,4,286,230,0
840,0,1,1,3,823,823,0.85714
480,0,1,1,4,502,502,1
240,0,1,0,2,261,261,0.28571
480,67,0,0,2,518,451,0.28571
480,-40,0,1,4,426,466,1
0,-18,0,0,1,-17,1,0.42857
480,0,1,1,3,488,488,0.85714
0,-38,0,0,4,-19,19,0
480,0,1,1,3,482,482,0.85714
240,0,1,1,3,228,228,0.85714
840,0,1,1,4,887,887,1
480,1,0,1,4,476,475,1
0,0,1,1,4,-6,-6,1
840,-86,0,0,1,825,911,0.42857
840,3,0,1,1,844,841,0.57143
840,0,1,1,2,823,823,0.71429
240,0,1,1,2,253,253,0.71429
0,0,1,1,2,-24,-24,0.71429
0,0,1,1,2,-7,-7,0.71429
0,0,1,1,2,7,7,0.71429
840,0,1,1,2,833,833,0.71429
240,0,1,1,3,229,229,0.85714
0,-12,0,0,4,-35,-23,0
480,-74,0,0,1,440,514,0.42857
240,0,1,1,1,244,244,0.57143
0,0,1,0,2,-16,-16,0.28571
840,-19,0,0,1,825,844,0.42857
480,19,0,0,1,489,470,0.42857
480,11,0,1,1,484,473,0.57143
240,-11,0,0,3,230,241,0.14286
840,0,1,0,2,833,833,0.28571
480,0,1,0,2,485,485,0.28571
480,0,1,1,1,511,511,0.57143
480,-2,0,0,1,485,487,0.42857
480,0,1,1,2,445,445,0.71429
0,-17,0,0,4,2,19,0
840,6,0,0,1,830,824,0.42857
840,-11,0,1,2,836,847,0.71429
480,4,0,1,2,499,495,0.71429
480,0,1,1,2,494,494,0.71429
0,10,0,0,4,1,-9,0
240,0,1,1,3,243,243,0.85714
480,-30,0,1,3,439,469,0.85714
0,0,1,1,4,8,8,1
840,29,0,0,3,876,847,0.14286
840,-10,0,0,2,834,844,0.28571
240,0,1,1,3,246,246,0.85714
480,29,0,1,2,480,451,0.71429
240,38,0,0,3,283,245,0.14286
0,-11,0,0,4,-21,-10,0
840,-5,0,1,2,832,837,0.71429
240,0,1,1,1,269,269,0.57143
0,0,1,1,3,15,15,0.85714
240,27,0,0,3,267,240,0.14286
240,-30,0,1,3,188,218,0.85714
480,11,0,0,2,470,459,0.28571
240,0,1,1,3,234,234,0.85714
480,-23,0,1,3,497,520,0.85714
840,0,1,0,3,866,866,0.14286
480,0,1,1,3,468,468,0.85714
0,2,0,1,4,10,8,1
840,0,1,0,2,833,833,0.28571
0,0,1,1,3,20,20,0.85714
480,0,1,1,4,466,466,1
240,15,0,1,4,230,215,1
240,8,0,0,3,201,193,0.14286
240,-3,0,1,4,253,256,1
0,0,1,1,4,-18,-18,1
240,0,1,1,4,246,246,1
840,0,1,0,3,858,858,0.14286
0,0,1,1,4,-39,-39,1
480,-57,0,0,4,433,490,0
240,-7,0,1,3,259,266,0.85714
840,0,1,1,3,829,829,0.85714
240,22,0,0,3,242,220,0.14286
480,11,0,0,3,454,443,0.14286
480,-50,0,0,3,472,522,0.14286
480,0,1,1,4,466,466,1
0,30,0,0,4,9,-21,0
840,-6,0,0,4,857,863,0
0,0,1,1,4,-4,-4,1
240,10,0,0,3,239,229,0.14286
840,0,1,1,3,819,819,0.85714
840,43,0,0,3,865,822,0.14286
840,0,1,0,4,859,859,0
480,38,0,0,4,499,461,0
840,0,1,0,3,828,828,0.14286
240,0,1,0,3,244,244,0.14286
840,0,1,0,3,883,883,0.14286
840,0,1,1,3,827,827,0.85714
480,8,0,0,3,501,493,0.14286
240,0,1,1,3,269,269,0.85714
840,17,0,0,1,864,847,0.42857
0,0,1,1,4,13,13,1
840,0,1,0,1,845,845,0.42857
480,-4,0,1,1,493,497,0.57143
480,0,1,1,3,493,493,0.85714
0,-4,0,0,3,-10,-6,0.14286
240,0,1,1,3,247,247,0.85714
0,-14,0,0,3,-3,11,0.14286
240,-9,0,0,3,218,227,0.14286
840,0,1,0,2,867,867,0.28571
840,0,1,1,3,843,843,0.85714
840,0,1,0,2,833,833,0.28571
240,47,0,0,3,245,198,0.14286
480,0,1,0,1,455,455,0.42857
0,-25,0,0,4,13,38,0
0,0,1,1,3,-20,-20,0.85714
480,-21,0,0,2,473,494,0.28571
480,0,1,1,3,495,495,0.85714
480,59,0,0,3,546,487,0.14286
240,0,1,0,3,225,225,0.14286
480,-37,0,1,3,452,489,0.85714
480,0,1,0,2,470,470,0.28571
0,-32,0,0,4,-38,-6,0
480,0,1,1,3,492,492,0.85714
240,-20,0,0,1,277,297,0.42857
240,0,1,0,2,268,268,0.28571
0,0,1,1,3,16,16,0.85714
240,-55,0,0,4,231,286,0
840,0,1,0,2,835,835,0.28571
840,-35,0,0,1,812,847,0.42857
840,0,1,0,1,847,847,0.42857
240,0,1,1,2,226,226,0.71429
240,-25,0,0,1,212,237,0.42857
840,3,0,1,3,808,805,0.85714
240,0,1,1,3,217,217,0.85714
840,0,1,1,3,834,834,0.85714
240,14,0,1,3,224,210,0.85714
240,9,0,1,3,253,244,0.85714
0,14,0,0,4,3,-11,0
480,0,1,1,2,461,461,0.71429
240,0,1,1,2,266,266,0.71429
840,0,1,0,2,811,811,0.28571
480,0,1,0,1,496,496,0.42857
0,21,0,0,4,-2,-23,0
840,0,1,0,3,805,805,0.14286
480,0,1,0,3,461,461,0.14286
0,0,1,1,3,14,14,0.85714
0,39,0,0,4,0,-39,0
480,0,1,1,4,514,514,1
0,30,0,0,4,-14,-44,0
0,50,0,0,4,10,-40,0
0,0,1,0,4,34,34,0
240,0,1,1,2,228,228,0.71429
840,50,0,0,4,866,816,0
840,16,0,1,2,861,845,0.71429
240,87,0,0,4,287,200,0
0,0,1,0,4,-19,-19,0
0,30,0,0,4,46,16,0
480,5,0,0,4,487,482,0
840,0,1,1,1,843,843,0.57143
0,27,0,0,4,-9,-36,0
0,17,0,1,2,-4,-21,0.71429
240,0,1,0,1,249,249,0.42857
480,0,1,1,2,532,532,0.71429
0,0,1,1,3,16,16,0.85714
0,0,1,0,3,8,8,0.14286
480,12,0,0,2,470,458,0.28571
480,0,1,1,3,491,491,0.85714
480,0,1,1,3,470,470,0.85714
480,-10,0,1,2,446,456,0.71429
840,-8,0,1,2,828,836,0.71429
0,-14,0,0,3,25,39,0.14286
0,16,0,1,3,-5,-21,0.85714
840,22,0,0,2,873,851,0.28571
480,33,0,0,2,481,448,0.28571
240,-12,0,1,2,250,262,0.71429
240,0,1,1,1,243,243,0.57143
0,0,1,0,1,0,0,0.42857
480,0,1,1,1,476,476,0.57143
240,0,1,0,2,214,214,0.28571
0,0,1,0,1,5,5,0.42857
840,0,1,0,1,818,818,0.42857
0,-67,0,0,4,-21,46,0
480,-18,0,1,1,456,474,0.57143
240,0,1,1,1,241,241,0.57143
240,0,1,1,1,241,241,0.57143
480,71,0,0,3,473,402,0.14286
840,0,1,1,2,828,828,0.71429
480,-22,0,0,1,477,499,0.42857
0,-33,0,0,3,-23,10,0.14286
480,0,1,1,2,490,490,0.71429
0,-8,0,1,3,1,9,0.85714
480,16,0,1,3,509,493,0.85714
840,-7,0,1,3,806,813,0.85714
480,20,0,0,3,485,465,0.14286
840,4,0,1,1,926,922,0.57143
480,0,1,1,1,471,471,0.57143
240,0,1,1,1,260,260,0.57143
480,-39,0,1,1,427,466,0.57143
0,0,1,1,2,12,12,0.71429
840,-25,0,0,2,826,851,0.28571
840,0,1,0,1,798,798,0.42857
240,0,1,1,2,260,260,0.71429
240,0,1,1,2,283,283,0.71429
0,18,0,0,3,-19,-37,0.14286
480,0,1,1,2,484,484,0.71429
0,0,1,1,2,10,10,0.71429
840,0,1,0,1,828,828,0.42857
840,0,1,0,1,851,851,0.42857
240,0,1,0,2,311,311,0.28571
240,-50,0,0,2,217,267,0.28571
0,0,1,1,2,-11,-11,0.71429
480,-20,0,1,2,455,475,0.71429
480,17,0,1,2,490,473,0.71429
0,22,0,0,3,15,-7,0.14286
480,0,1,0,2,493,493,0.28571
840,0,1,0,1,837,837,0.42857
840,0,1,1,1,821,821,0.57143
840,0,1,0,3,832,832,0.14286
0,-7,0,0,3,0,7,0.14286
840,0,1,0,2,806,806,0.28571
240,-45,0,0,4,226,271,0
840,0,1,1,2,807,807,0.71429
840,-38,0,0,1,831,869,0.42857
480,-47,0,0,2,465,512,0.28571
0,0,1,1,2,0,0,0.71429
0,0,1,1,2,4,4,0.71429
240,0,1,1,2,230,230,0.71429
240,-68,0,0,3,178,246,0.14286
840,22,0,1,3,855,833,0.85714
0,0,1,1,3,-7,-7,0.85714
480,0,1,1,3,482,482,0.85714
840,0,1,0,1,805,805,0.42857
480,35,0,1,1,513,478,0.57143
480,0,1,1,3,466,466,0.85714
0,0,1,1,3,33,33,0.85714
840,16,0,0,1,834,818,0.42857
0,36,0,0,4,13,-23,0
840,0,1,1,2,822,822,0.71429
0,0,1,1,3,-4,-4,0.85714
840,0,1,0,1,846,846,0.42857
0,0,1,1,3,21,21,0.85714
0,-31,0,0,3,15,46,0.14286
840,-51,0,0,3,816,867,0.14286
480,0,1,1,3,515,515,0.85714
480,26,0,0,1,486,460,0.42857
240,-18,0,1,3,223,241,0.85714
480,0,1,1,4,492,492,1
0,1,0,1,4,29,28,1
840,0,1,0,1,835,835,0.42857
240,19,0,1,3,261,242,0.85714
480,0,1,1,4,475,475,1
840,30,0,0,1,865,835,0.42857
840,-23,0,0,2,839,862,0.28571
0,-10,0,0,3,-19,-9,0.14286
0,-89,0,0,4,-49,40,0
0,-7,0,0,1,-20,-13,0.42857
840,-51,0,0,3,782,833,0.14286
840,0,1,0,1,850,850,0.42857
480,0,1,1,1,482,482,0.57143
240,32,0,0,1,261,229,0.42857
480,0,1,1,2,452,452,0.71429
0,0,1,1,2,-11,-11,0.71429
240,10,0,1,3,233,223,0.85714
480,0,1,0,1,514,514,0.42857
480,0,1,1,3,468,468,0.85714
0,-34,0,0,3,4,38,0.14286
840,3,0,0,1,865,862,0.42857
0,0,1,1,1,-31,-31,0.57143
840,28,0,0,1,845,817,0.42857
0,0,1,1,3,-35,-35,0.85714
240,0,1,1,3,229,229,0.85714
240,-17,0,0,1,246,263,0.42857
840,0,1,0,2,859,859,0.28571
240,0,1,1,2,224,224,0.71429
480,0,1,1,2,494,494,0.71429
840,1,0,0,1,823,822,0.42857
0,41,0,0,4,13,-28,0
240,-68,0,0,4,223,291,0
0,0,1,1,3,-27,-27,0.85714
0,0,1,1,3,22,22,0.85714
840,19,0,0,1,884,865,0.42857
840,19,0,1,4,891,872,1
0,0,1,1,4,9,9,1
240,-31,0,0,4,217,248,0
480,64,0,0,4,500,436,0
480,0,1,1,1,477,477,0.57143
240,26,0,0,2,260,234,0.28571
240,-27,0,0,3,235,262,0.14286
840,-27,0,0,3,838,865,0.14286
480,22,0,1,1,452,430,0.57143
0,-24,0,0,4,-46,-22,0
0,0,1,1,3,-30,-30,0.85714
480,37,0,0,1,497,460,0.42857
840,0,1,0,2,844,844,0.28571
240,-7,0,1,2,214,221,0.71429
480,-13,0,1,3,473,486,0.85714
240,42,0,0,2,274,232,0.28571
840,0,1,0,3,852,852,0.14286
240,0,1,1,3,242,242,0.85714
480,11,0,1,3,546,535,0.85714
480,0,1,1,3,516,516,0.85714
0,-2,0,1,3,-12,-10,0.85714
0,0,1,1,4,8,8,1
840,0,1,0,1,872,872,0.42857
0,24,0,0,3,42,18,0.14286
0,0,1,1,3,-8,-8,0.85714
840,0,1,1,4,856,856,1
480,-63,0,0,3,457,520,0.14286
480,0,1,0,1,455,455,0.42857
240,-4,0,0,1,241,245,0.42857
240,64,0,0,4,251,187,0
240,-66,0,0,4,205,271,0
240,0,1,1,3,248,248,0.85714
480,0,1,1,3,467,467,0.85714
480,0,1,0,3,490,490,0.14286
240,0,1,1,4,270,270,1
840,26,0,0,4,852,826,0
240,0,1,1,3,221,221,0.85714
840,0,1,0,1,811,811,0.42857
480,22,0,0,2,490,468,0.28571
240,10,0,0,1,252,242,0.42857
840,-5,0,0,1,888,893,0.42857
480,12,0,0,1,465,453,0.42857
0,13,0,0,1,19,6,0.42857
840,33,0,0,3,839,806,0.14286
480,0,1,1,1,504,504,0.57143
840,-1,0,1,2,839,840,0.71429
480,-19,0,0,1,438,457,0.42857
0,-42,0,0,4,-30,12,0
240,0,1,1,3,223,223,0.85714
840,-12,0,0,2,844,856,0.28571
240,16,0,1,3,244,228,0.85714
240,0,1,1,3,259,259,0.85714
240,0,1,1,3,251,251,0.85714
240,0,1,1,3,231,231,0.85714
840,0,1,0,1,814,814,0.42857
840,16,0,0,3,801,785,0.14286
480,-2,0,1,2,473,475,0.71429
480,-7,0,0,1,454,461,0.42857
240,0,1,1,3,217,217,0.85714
840,0,1,1,3,838,838,0.85714
240,-8,0,1,4,247,255,1
480,0,1,1,4,511,511,1
0,0,1,1,4,7,7,1
0,0,1,1,4,-10,-10,1
480,0,1,1,4,521,521,1
240,53,0,0,4,274,221,0
840,0,1,0,1,836,836,0.42857
480,0,1,0,2,479,479,0.28571
240,0,1,0,1,263,263,0.42857
0,10,0,0,1,19,9,0.42857
480,0,1,0,2,499,499,0.28571
480,-41,0,0,2,452,493,0.28571
0,0,1,1,4,30,30,1
240,0,1,1,4,230,230,1
0,0,1,1,4,-36,-36,1
480,-84,0,0,4,433,517,0
840,0,1,0,1,819,819,0.42857
480,45,0,0,1,481,436,0.42857
480,-37,0,0,2,437,474,0.28571
480,0,1,0,1,499,499,0.42857
840,0,1,0,1,831,831,0.42857
840,0,1,0,1,814,814,0.42857
240,-53,0,0,4,216,269,0
480,0,1,1,3,482,482,0.85714
480,0,1,0,1,472,472,0.42857
480,6,0,0,1,498,492,0.42857
840,28,0,0,1,853,825,0.42857
480,-27,0,0,1,466,493,0.42857
0,0,1,1,4,14,14,1
240,-20,0,0,1,247,267,0.42857
240,-7,0,0,1,233,240,0.42857
480,1,0,0,1,490,489,0.42857
240,0,1,1,1,253,253,0.57143
0,14,0,0,2,28,14,0.28571
240,0,1,1,3,239,239,0.85714
0,0,1,0,1,63,63,0.42857
240,0,1,0,3,306,306,0.14286
240,0,1,1,3,232,232,0.85714
480,0,1,1,2,488,488,0.71429
840,0,1,0,1,849,849,0.42857
0,0,1,1,3,3,3,0.85714
240,0,1,1,4,222,222,1
480,0,1,1,4,466,466,1
480,56,0,0,1,512,456,0.42857
840,-18,0,1,2,808,826,0.71429
240,0,1,1,3,208,208,0.85714
480,0,1,1,3,480,480,0.85714
480,0,1,1,3,481,481,0.85714
0,0,1,1,3,-31,-31,0.85714
0,0,1,1,4,39,39,1
0,0,1,1,3,-34,-34,0.85714
240,0,1,1,3,255,255,0.85714
240,-6,0,1,3,223,229,0.85714
480,0,1,1,3,484,484,0.85714
480,0,1,1,4,516,516,1
0,22,0,0,4,4,-18,0
840,55,0,0,4,887,832,0
240,9,0,1,4,235,226,1
0,-37,0,0,4,-21,16,0
240,0,1,0,1,231,231,0.42857
480,-11,0,0,1,450,461,0.42857
480,0,1,0,2,458,458,0.28571
240,0,1,0,2,242,242,0.28571
240,0,1,0,1,202,202,0.42857
240,0,1,1,1,246,246,0.57143
240,-4,0,1,1,261,265,0.57143
0,0,1,1,3,12,12,0.85714
480,0,1,0,1,480,480,0.42857
840,0,1,0,1,874,874,0.42857
0,0,1,1,4,3,3,1
0,-26,0,0,4,-18,8,0
480,-44,0,0,1,452,496,0.42857
840,20,0,0,2,882,862,0.28571
840,0,1,0,1,835,835,0.42857
840,0,1,0,1,843,843,0.42857
840,-11,0,0,1,832,843,0.42857
480,36,0,1,3,525,489,0.85714
480,-67,0,0,1,447,514,0.42857
240,0,1,1,3,267,267,0.85714
240,0,1,1,4,260,260,1
840,0,1,0,1,840,840,0.42857
0,0,1,1,4,-17,-17,1
0,0,1,1,4,-6,-6,1
840,0,1,0,1,851,851,0.42857
240,22,0,1,4,250,228,1
840,17,0,0,1,865,848,0.42857
240,-5,0,1,4,228,233,1
0,16,0,0,1,-23,-39,0.42857
840,0,1,1,4,882,882,1
480,48,0,0,1,497,449,0.42857
0,0,1,1,4,16,16,1
840,0,1,0,1,854,854,0.42857
0,0,1,1,4,-19,-19,1
480,0,1,0,1,441,441,0.42857
240,0,1,1,4,184,184,1
0,0,1,1,4,57,57,1
840,0,1,0,1,803,803,0.42857
0,3,0,1,4,-4,-7,1
240,-17,0,1,4,191,208,1
0,-25,0,0,4,-21,4,0
0,36,0,0,4,17,-19,0
0,-15,0,0,4,-24,-9,0
0,-11,0,0,4,-30,-19,0
240,9,0,1,1,222,213,0.57143
240,0,1,1,2,290,290,0.71429
480,14,0,0,1,529,515,0.42857
0,-37,0,0,4,-14,23,0
240,23,0,1,3,242,219,0.85714
0,22,0,0,4,-9,-31,0
240,0,1,0,2,232,232,0.28571
480,2,0,1,1,470,468,0.57143
840,0,1,0,1,832,832,0.42857
0,0,1,0,4,-16,-16,0
240,0,1,0,1,236,236,0.42857
480,69,0,0,4,537,468,0
240,0,1,0,1,231,231,0.42857
480,0,1,1,1,502,502,0.57143
840,35,0,0,1,834,799,0.42857
840,12,0,0,1,873,861,0.42857
240,4,0,1,2,238,234,0.71429
0,14,0,0,4,48,34,0
840,18,0,0,1,851,833,0.42857
240,0,1,1,1,214,214,0.57143
0,0,1,1,2,55,55,0.71429
240,56,0,0,1,244,188,0.42857
240,0,1,1,2,278,278,0.71429
0,17,0,0,1,15,-2,0.42857
240,-30,0,0,1,239,269,0.42857
480,0,1,1,2,479,479,0.71429
840,51,0,0,2,884,833,0.28571
240,-9,0,0,3,224,233,0.14286
0,-3,0,1,2,-14,-11,0.71429
480,1,0,0,1,475,474,0.42857
0,0,1,1,2,-23,-23,0.71429
240,0,1,0,1,225,225,0.42857
840,21,0,0,2,863,842,0.28571
840,-21,0,0,1,845,866,0.42857
480,0,1,1,2,456,456,0.71429
0,68,0,0,4,20,-48,0
240,-14,0,0,3,223,237,0.14286
240,0,1,1,2,251,251,0.71429
840,0,1,1,2,817,817,0.71429
480,-1,0,1,2,511,512,0.71429
840,-10,0,1,2,840,850,0.71429
240,13,0,1,3,219,206,0.85714
0,0,1,1,3,12,12,0.85714
840,0,1,1,1,841,841,0.57143
0,0,1,1,3,-44,-44,0.85714
240,52,0,0,3,259,207,0.14286
0,0,1,1,4,-13,-13,1
840,-5,0,0,1,830,835,0.42857
0,51,0,0,4,28,-23,0
0,0,1,1,3,-26,-26,0.85714
840,18,0,0,3,862,844,0.14286
480,9,0,0,2,484,475,0.28571
0,47,0,0,4,48,1,0
480,9,0,1,2,478,469,0.71429
240,-15,0,1,3,218,233,0.85714
480,0,1,1,1,458,458,0.57143
0,15,0,0,4,13,-2,0
840,39,0,0,1,840,801,0.42857
0,17,0,0,1,-29,-46,0.42857
0,-14,0,0,4,1,15,0
0,0,1,0,1,64,64,0.42857
0,0,1,1,2,-14,-14,0.71429
240,0,1,0,1,259,259,0.42857
480,0,1,1,2,490,490,0.71429
840,0,1,1,3,869,869,0.85714
0,-10,0,0,4,1,11,0
840,-2,0,0,1,853,855,0.42857
840,-57,0,0,2,815,872,0.28571
0,2,0,0,1,12,10,0.42857
0,-22,0,0,3,-16,6,0.14286
240,-12,0,0,2,238,250,0.28571
240,-5,0,0,1,226,231,0.42857
480,0,1,0,1,457,457,0.42857
480,3,0,1,1,468,465,0.57143
240,0,1,0,1,252,252,0.42857
480,0,1,1,1,451,451,0.57143
480,-32,0,0,3,479,511,0.14286
240,14,0,1,1,239,225,0.57143
480,0,1,1,1,485,485,0.57143
240,0,1,1,2,226,226,0.71429
840,7,0,0,1,818,811,0.42857
240,35,0,0,2,291,256,0.28571
0,0,1,1,3,38,38,0.85714
480,0,1,1,3,511,511,0.85714
0,0,1,1,4,20,20,1
480,0,1,0,1,490,490,0.42857
240,0,1,1,3,260,260,0.85714
0,-16,0,0,3,-20,-4,0.14286
480,0,1,1,3,473,473,0.85714
480,-51,0,0,1,487,538,0.42857
240,0,1,1,4,257,257,1
480,-22,0,0,1,489,511,0.42857
480,0,1,1,2,470,470,0.71429
840,-56,0,0,4,780,836,0
0,0,1,1,4,44,44,1
840,93,0,0,4,901,808,0
0,0,1,1,4,20,20,1
840,-24,0,1,4,832,856,1
840,0,1,0,1,860,860,0.42857
480,-6,0,0,2,468,474,0.28571
240,0,1,1,3,218,218,0.85714
840,0,1,1,3,766,766,0.85714
240,-16,0,0,1,234,250,0.42857
240,12,0,1,4,262,250,1
480,-11,0,1,3,460,471,0.85714
0,19,0,0,4,11,-8,0
840,0,1,1,3,832,832,0.85714
840,-59,0,0,1,827,886,0.42857
240,0,1,1,2,233,233,0.71429
480,36,0,0,1,502,466,0.42857
840,0,1,0,1,818,818,0.42857
0,-28,0,0,4,-18,10,0
840,-30,0,1,3,855,885,0.85714
240,0,1,1,3,248,248,0.85714
480,-2,0,0,1,477,479,0.42857
840,38,0,0,1,858,820,0.42857
480,44,0,0,1,508,464,0.42857
840,0,1,0,2,803,803,0.28571
840,-49,0,0,1,804,853,0.42857
480,3,0,0,1,484,481,0.42857
0,88,0,0,4,85,-3,0
240,0,1,0,1,186,186,0.42857
840,31,0,0,1,853,822,0.42857
240,0,1,0,1,258,258,0.42857
480,-17,0,1,4,486,503,1
840,-27,0,0,1,823,850,0.42857
840,27,0,1,1,848,821,0.57143
240,0,1,1,1,268,268,0.57143
240,-37,0,0,4,194,231,0
840,-50,0,0,3,809,859,0.14286
240,0,1,0,1,231,231,0.42857
240,0,1,0,1,225,225,0.42857
0,-6,0,1,1,12,18,0.57143
840,-2,0,1,1,857,859,0.57143
0,13,0,0,3,7,-6,0.14286
0,-43,0,0,4,-18,25,0
480,-26,0,0,1,483,509,0.42857
480,0,1,0,1,484,484,0.42857
840,0,1,0,1,841,841,0.42857
480,-37,0,0,1,446,483,0.42857
840,0,1,0,1,838,838,0.42857
840,0,1,1,1,863,863,0.57143
840,-32,0,0,1,803,835,0.42857
480,-51,0,0,1,434,485,0.42857
840,0,1,0,2,846,846,0.28571
240,50,0,1,1,303,253,0.57143
240,0,1,1,2,278,278,0.71429
240,30,0,0,1,255,225,0.42857
840,0,1,1,2,832,832,0.71429
240,0,1,1,1,235,235,0.57143
480,0,1,1,3,497,497,0.85714
0,-2,0,1,4,2,4,1
240,0,1,1,4,253,253,1
480,20,0,0,1,505,485,0.42857
0,0,1,1,4,17,17,1
840,30,0,0,2,872,842,0.28571
840,0,1,0,1,826,826,0.42857
0,-14,0,1,3,-33,-19,0.85714
0,-36,0,0,4,-42,-6,0
0,0,1,1,4,3,3,1
240,24,0,1,1,277,253,0.57143
0,0,1,1,4,4,4,1
840,0,1,0,1,865,865,0.42857
240,0,1,1,4,251,251,1
840,0,1,1,4,907,907,1
0,-25,0,0,4,-7,18,0
840,-44,0,0,1,806,850,0.42857
480,-9,0,0,1,454,463,0.42857
240,0,1,0,1,216,216,0.42857
240,0,1,1,2,236,236,0.71429
240,0,1,1,3,204,204,0.85714
0,0,1,1,3,-4,-4,0.85714
240,37,0,0,1,238,201,0.42857
840,0,1,0,2,837,837,0.28571
840,-26,0,1,2,805,831,0.71429
0,0,1,1,3,-33,-33,0.85714
0,26,0,0,4,40,14,0
0,0,1,0,4,10,10,0
840,0,1,0,4,801,801,0
0,0,1,1,4,-7,-7,1
0,0,1,1,4,-28,-28,1
840,0,1,0,1,813,813,0.42857
480,0,1,0,1,497,497,0.42857
0,0,1,1,4,-53,-53,1
840,-51,0,1,4,808,859,1
840,-13,0,0,1,842,855,0.42857
240,0,1,1,1,244,244,0.57143
0,0,1,1,2,-16,-16,0.71429
840,-19,0,0,2,825,844,0.28571
480,19,0,1,2,489,470,0.71429
480,11,0,1,2,484,473,0.71429
240,-11,0,0,1,230,241,0.42857
840,0,1,0,1,833,833,0.42857
480,0,1,1,2,485,485,0.71429
480,0,1,1,3,511,511,0.85714
480,-2,0,1,3,485,487,0.85714
480,0,1,1,3,445,445,0.85714
0,-17,0,1,4,2,19,1
840,6,0,1,4,830,824,1
840,-11,0,0,4,836,847,0
480,4,0,0,2,499,495,0.28571
480,0,1,1,2,494,494,0.71429
0,10,0,0,4,1,-9,0
240,0,1,1,2,243,243,0.71429
480,-30,0,1,3,439,469,0.85714
0,0,1,0,3,8,8,0.14286
840,29,0,1,2,876,847,0.71429
840,-10,0,1,3,834,844,0.85714
240,0,1,1,3,246,246,0.85714
480,29,0,1,3,480,451,0.85714
240,38,0,0,4,283,245,0
0,-11,0,0,4,-21,-10,0
840,-5,0,1,2,832,837,0.71429
240,0,1,1,2,269,269,0.71429
0,0,1,1,3,15,15,0.85714
240,27,0,0,2,267,240,0.28571
240,-30,0,1,3,188,218,0.85714
480,11,0,0,1,470,459,0.42857
240,0,1,0,1,234,234,0.42857
480,-23,0,1,3,497,520,0.85714
840,0,1,1,1,866,866,0.57143
480,0,1,0,1,468,468,0.42857
0,2,0,1,3,10,8,0.85714
840,0,1,1,3,833,833,0.85714
0,0,1,1,3,20,20,0.85714
480,0,1,1,3,466,466,0.85714
240,15,0,1,3,230,215,0.85714
240,8,0,1,3,201,193,0.85714
240,-3,0,1,3,253,256,0.85714
0,0,1,1,3,-18,-18,0.85714
240,0,1,1,3,246,246,0.85714
840,0,1,0,2,858,858,0.28571
0,0,1,1,4,-39,-39,1
480,-57,0,0,3,433,490,0.14286
240,-7,0,1,2,259,266,0.71429
840,0,1,1,1,829,829,0.57143
240,22,0,1,3,242,220,0.85714
480,11,0,1,2,454,443,0.71429
480,-50,0,1,1,472,522,0.57143
480,0,1,1,2,466,466,0.71429
0,30,0,0,4,9,-21,0
840,-6,0,1,1,857,863,0.57143
0,0,1,1,3,-4,-4,0.85714
240,10,0,0,4,239,229,0
840,0,1,1,1,819,819,0.57143
840,43,0,0,4,865,822,0
840,0,1,1,2,859,859,0.71429
480,38,0,0,3,499,461,0.14286
840,0,1,1,1,828,828,0.57143
240,0,1,1,1,244,244,0.57143
840,0,1,1,1,883,883,0.57143
840,0,1,1,1,827,827,0.57143
480,8,0,0,1,501,493,0.42857
240,0,1,0,1,269,269,0.42857
840,17,0,1,1,864,847,0.57143
0,0,1,1,2,13,13,0.71429
840,0,1,1,2,845,845,0.71429
480,-4,0,1,2,493,497,0.71429
480,0,1,1,2,493,493,0.71429
0,-4,0,1,2,-10,-6,0.71429
240,0,1,1,3,247,247,0.85714
0,-14,0,0,3,-3,11,0.14286
240,-9,0,1,2,218,227,0.71429
840,0,1,1,2,867,867,0.71429
840,0,1,0,2,843,843,0.28571
840,0,1,1,2,833,833,0.71429
240,47,0,0,3,245,198,0.14286
480,0,1,1,2,455,455,0.71429
0,-25,0,0,4,13,38,0
0,0,1,1,1,-20,-20,0.57143
480,-21,0,1,1,473,494,0.57143
480,0,1,1,1,495,495,0.57143
480,59,0,0,3,546,487,0.14286
240,0,1,1,2,225,225,0.71429
480,-37,0,1,3,452,489,0.85714
480,0,1,1,3,470,470,0.85714
0,-32,0,0,4,-38,-6,0
480,0,1,1,3,492,492,0.85714
240,-20,0,0,2,277,297,0.28571
240,0,1,0,2,268,268,0.28571
0,0,1,1,3,16,16,0.85714
240,-55,0,0,4,231,286,0
840,0,1,0,3,835,835,0.14286
840,-35,0,0,2,812,847,0.28571
840,0,1,0,1,847,847,0.42857
240,0,1,1,3,226,226,0.85714
240,-25,0,0,3,212,237,0.14286
840,3,0,1,1,808,805,0.57143
240,0,1,1,2,217,217,0.71429
840,0,1,1,2,834,834,0.71429
240,14,0,1,3,224,210,0.85714
240,9,0,1,3,253,244,0.85714
0,14,0,1,3,3,-11,0.85714
480,0,1,1,3,461,461,0.85714
240,0,1,1,4,266,266,1
840,0,1,1,4,811,811,1
480,0,1,1,3,496,496,0.85714
0,21,0,0,4,-2,-23,0
840,0,1,1,1,805,805,0.57143
480,0,1,1,2,461,461,0.71429
0,0,1,1,3,14,14,0.85714
0,39,0,0,4,0,-39,0
480,0,1,1,2,514,514,0.71429
0,30,0,0,4,-14,-44,0
0,50,0,0,4,10,-40,0
0,0,1,1,3,34,34,0.85714
240,0,1,1,1,228,228,0.57143
840,50,0,0,4,866,816,0
840,16,0,0,4,861,845,0
240,87,0,0,4,287,200,0
0,0,1,0,4,-19,-19,0
0,30,0,0,4,46,16,0
480,5,0,1,1,487,482,0.57143
840,0,1,0,1,843,843,0.42857
0,27,0,0,4,-9,-36,0
0,17,0,0,4,-4,-21,0
240,0,1,1,1,249,249,0.57143
480,0,1,1,1,532,532,0.57143
0,0,1,1,1,16,16,0.57143
0,0,1,1,1,8,8,0.57143
480,12,0,0,2,470,458,0.28571
480,0,1,0,2,491,491,0.28571
480,0,1,1,2,470,470,0.71429
480,-10,0,0,1,446,456,0.42857
840,-8,0,0,1,828,836,0.42857
0,-14,0,0,4,25,39,0
0,16,0,0,4,-5,-21,0
840,22,0,0,4,873,851,0
480,33,0,0,4,481,448,0
240,-12,0,1,1,250,262,0.57143
240,0,1,1,1,243,243,0.57143
0,0,1,1,2,0,0,0.71429
480,0,1,1,2,476,476,0.71429
240,0,1,1,2,214,214,0.71429
0,0,1,1,3,5,5,0.85714
840,0,1,0,2,818,818,0.28571
0,-67,0,0,4,-21,46,0
480,-18,0,1,3,456,474,0.85714
240,0,1,0,1,241,241,0.42857
240,0,1,1,2,241,241,0.71429
480,71,0,0,4,473,402,0
840,0,1,1,1,828,828,0.57143
480,-22,0,0,1,477,499,0.42857
0,-33,0,0,4,-23,10,0
480,0,1,1,1,490,490,0.57143
0,-8,0,1,1,1,9,0.57143
480,16,0,0,1,509,493,0.42857
840,-7,0,0,1,806,813,0.42857
480,20,0,0,1,485,465,0.42857
840,4,0,0,1,926,922,0.42857
480,0,1,1,2,471,471,0.71429
240,0,1,1,2,260,260,0.71429
480,-39,0,0,1,427,466,0.42857
0,0,1,1,2,12,12,0.71429
840,-25,0,1,2,826,851,0.71429
840,0,1,1,2,798,798,0.71429
240,0,1,1,2,260,260,0.71429
240,0,1,1,2,283,283,0.71429
0,18,0,0,3,-19,-37,0.14286
480,0,1,1,2,484,484,0.71429
0,0,1,1,2,10,10,0.71429
840,0,1,1,2,828,828,0.71429
840,0,1,0,2,851,851,0.28571
240,0,1,1,3,311,311,0.85714
240,-50,0,0,2,217,267,0.28571
0,0,1,1,3,-11,-11,0.85714
480,-20,0,1,3,455,475,0.85714
480,17,0,1,3,490,473,0.85714
0,22,0,0,4,15,-7,0
480,0,1,0,3,493,493,0.14286
840,0,1,1,3,837,837,0.85714
840,0,1,1,3,821,821,0.85714
840,0,1,1,3,832,832,0.85714
0,-7,0,0,3,0,7,0.14286
840,0,1,0,3,806,806,0.14286
240,-45,0,0,4,226,271,0
840,0,1,0,4,807,807,0
840,-38,0,0,4,831,869,0
480,-47,0,0,4,465,512,0
0,0,1,1,3,0,0,0.85714
0,0,1,1,3,4,4,0.85714
240,0,1,1,3,230,230,0.85714
240,-68,0,1,4,178,246,1
840,22,0,0,3,855,833,0.14286
0,0,1,1,4,-7,-7,1
480,0,1,0,1,482,482,0.42857
840,0,1,0,3,805,805,0.14286
480,35,0,1,3,513,478,0.85714
480,0,1,1,3,466,466,0.85714
0,0,1,1,3,33,33,0.85714
840,16,0,0,2,834,818,0.28571
0,36,0,0,4,13,-23,0
840,0,1,0,3,822,822,0.14286
0,0,1,1,4,-4,-4,1
840,0,1,0,3,846,846,0.14286
0,0,1,0,1,21,21,0.42857
0,-31,0,0,4,15,46,0
840,-51,0,0,4,816,867,0
480,0,1,1,3,515,515,0.85714
480,26,0,0,1,486,460,0.42857
240,-18,0,0,1,223,241,0.42857
480,0,1,1,2,492,492,0.71429
0,1,0,0,1,29,28,0.42857
840,0,1,0,1,835,835,0.42857
240,19,0,1,3,261,242,0.85714
480,0,1,0,1,475,475,0.42857
840,30,0,0,1,865,835,0.42857
840,-23,0,0,2,839,862,0.28571
0,-10,0,0,3,-19,-9,0.14286
0,-89,0,0,4,-49,40,0
840,-51,0,0,1,782,833,0.42857
840,0,1,0,3,850,850,0.14286
480,0,1,0,2,482,482,0.28571
240,32,0,0,2,261,229,0.28571
480,0,1,0,2,452,452,0.28571
0,0,1,1,3,-11,-11,0.85714
240,10,0,1,3,233,223,0.85714
480,0,1,1,3,514,514,0.85714
480,0,1,0,2,468,468,0.28571
0,-34,0,0,4,4,38,0
840,3,0,0,2,865,862,0.28571
0,0,1,1,3,-31,-31,0.85714
840,28,0,0,1,845,817,0.42857
0,0,1,1,3,-35,-35,0.85714
240,0,1,1,3,229,229,0.85714
240,-17,0,1,1,246,263,0.57143
840,0,1,0,1,859,859,0.42857
240,0,1,1,1,224,224,0.57143
480,0,1,1,1,494,494,0.57143
840,1,0,1,2,823,822,0.71429
0,41,0,0,4,13,-28,0
240,-68,0,0,4,223,291,0
0,0,1,1,2,-27,-27,0.71429
0,0,1,1,2,22,22,0.71429
840,19,0,1,2,884,865,0.71429
840,19,0,1,2,891,872,0.71429
0,0,1,1,2,9,9,0.71429
240,-31,0,0,2,217,248,0.28571
480,64,0,0,2,500,436,0.28571
480,0,1,1,2,477,477,0.71429
240,26,0,0,3,260,234,0.14286
240,-27,0,0,2,235,262,0.28571
840,-27,0,0,2,838,865,0.28571
480,22,0,1,2,452,430,0.71429
0,-24,0,0,3,-46,-22,0.14286
0,0,1,1,2,-30,-30,0.71429
480,37,0,0,1,497,460,0.42857
840,0,1,0,1,844,844,0.42857
240,-7,0,0,1,214,221,0.42857
480,-13,0,1,2,473,486,0.71429
240,42,0,0,2,274,232,0.28571
840,0,1,0,2,852,852,0.28571
240,0,1,1,2,242,242,0.71429
480,11,0,1,2,546,535,0.71429
480,0,1,1,2,516,516,0.71429
0,-2,0,1,2,-12,-10,0.71429
0,0,1,1,2,8,8,0.71429
840,0,1,1,2,872,872,0.71429
0,24,0,0,3,42,18,0.14286
0,0,1,1,2,-8,-8,0.71429
840,0,1,1,2,856,856,0.71429
480,-63,0,0,3,457,520,0.14286
480,0,1,1,2,455,455,0.71429
240,-4,0,1,2,241,245,0.71429
240,64,0,0,3,251,187,0.14286
240,-66,0,0,3,205,271,0.14286
240,0,1,1,2,248,248,0.71429
480,0,1,1,2,467,467,0.71429
480,0,1,0,2,490,490,0.28571
240,0,1,1,2,270,270,0.71429
840,26,0,0,3,852,826,0.14286
240,0,1,1,2,221,221,0.71429
840,0,1,0,3,811,811,0.14286
480,22,0,0,3,490,468,0.14286
240,10,0,0,3,252,242,0.14286
840,-5,0,1,1,888,893,0.57143
480,12,0,0,2,465,453,0.28571
0,13,0,0,3,19,6,0.14286
840,33,0,0,3,839,806,0.14286
480,0,1,0,3,504,504,0.14286
840,-1,0,0,3,839,840,0.14286
480,-19,0,1,1,438,457,0.57143
0,-42,0,0,4,-30,12,0
240,0,1,0,4,223,223,0
840,-12,0,0,1,844,856,0.42857
240,16,0,1,2,244,228,0.71429
240,0,1,1,2,259,259,0.71429
240,0,1,1,2,251,251,0.71429
240,0,1,0,1,231,231,0.42857
840,0,1,1,1,814,814,0.57143
840,16,0,1,1,801,785,0.57143
480,-2,0,1,2,473,475,0.71429
480,-7,0,1,2,454,461,0.71429
240,0,1,1,2,217,217,0.71429
840,0,1,1,2,838,838,0.71429
240,-8,0,1,2,247,255,0.71429
480,0,1,1,2,511,511,0.71429
0,0,1,1,2,7,7,0.71429
0,0,1,0,2,-10,-10,0.28571
480,0,1,1,2,521,521,0.71429
240,53,0,0,4,274,221,0
840,0,1,1,2,836,836,0.71429
480,0,1,1,2,479,479,0.71429
240,0,1,1,2,263,263,0.71429
0,10,0,0,3,19,9,0.14286
480,0,1,1,2,499,499,0.71429
480,-41,0,1,3,452,493,0.85714
0,0,1,1,3,30,30,0.85714
240,0,1,1,3,230,230,0.85714
0,0,1,1,3,-36,-36,0.85714
480,-84,0,0,4,433,517,0
840,0,1,1,2,819,819,0.71429
480,45,0,0,3,481,436,0.14286
480,-37,0,0,4,437,474,0
480,0,1,1,2,499,499,0.71429
840,0,1,1,2,831,831,0.71429
840,0,1,0,1,814,814,0.42857
240,-53,0,0,3,216,269,0.14286
480,0,1,1,3,482,482,0.85714
480,0,1,1,3,472,472,0.85714
480,6,0,0,1,498,492,0.42857
840,28,0,0,2,853,825,0.28571
480,-27,0,1,3,466,493,0.85714
0,0,1,1,3,14,14,0.85714
240,-20,0,0,3,247,267,0.14286
240,-7,0,1,3,233,240,0.85714
480,1,0,1,3,490,489,0.85714
240,0,1,0,1,253,253,0.42857
0,14,0,0,3,28,14,0.14286
240,0,1,1,3,239,239,0.85714
0,0,1,0,1,63,63,0.42857
240,0,1,1,3,306,306,0.85714
240,0,1,1,3,232,232,0.85714
480,0,1,1,3,488,488,0.85714
840,0,1,0,3,849,849,0.14286
0,0,1,1,3,3,3,0.85714
240,0,1,1,3,222,222,0.85714
480,0,1,1,3,466,466,0.85714
480,56,0,0,4,512,456,0
840,-18,0,0,2,808,826,0.28571
240,0,1,1,3,208,208,0.85714
480,0,1,1,3,480,480,0.85714
480,0,1,0,2,481,481,0.28571
0,0,1,1,3,-31,-31,0.85714
0,0,1,1,3,39,39,0.85714
0,-10,0,0,3,29,39,0.14286
0,0,1,1,3,-34,-34,0.85714
240,0,1,0,2,255,255,0.28571
240,-6,0,1,3,223,229,0.85714
480,0,1,1,3,484,484,0.85714
480,0,1,1,3,516,516,0.85714
0,22,0,0,4,4,-18,0
840,55,0,0,4,887,832,0
240,9,0,1,3,235,226,0.85714
0,-37,0,0,4,-21,16,0
240,0,1,0,1,231,231,0.42857
480,-11,0,1,4,450,461,1
480,0,1,0,1,458,458,0.42857
240,0,1,0,1,242,242,0.42857
240,0,1,1,4,202,202,1
240,0,1,1,4,246,246,1
240,-4,0,1,4,261,265,1
0,0,1,0,4,12,12,0
480,0,1,1,4,480,480,1
840,0,1,0,4,874,874,0
0,0,1,0,1,3,3,0.42857
0,-26,0,0,4,-18,8,0
480,-44,0,0,1,452,496,0.42857
840,20,0,1,1,882,862,0.57143
840,0,1,0,1,835,835,0.42857
840,0,1,0,1,843,843,0.42857
840,-11,0,0,1,832,843,0.42857
480,36,0,1,1,525,489,0.57143
480,-67,0,0,1,447,514,0.42857
240,0,1,1,1,267,267,0.57143
240,0,1,1,1,260,260,0.57143
840,0,1,0,1,840,840,0.42857
0,0,1,1,1,-17,-17,0.57143
0,0,1,0,2,-6,-6,0.28571
840,0,1,0,2,851,851,0.28571
240,22,0,0,3,250,228,0.14286
840,17,0,0,1,865,848,0.42857
240,-5,0,0,4,228,233,0
0,16,0,0,4,-23,-39,0
840,0,1,1,1,882,882,0.57143
480,48,0,0,1,497,449,0.42857
0,0,1,1,2,16,16,0.71429
840,0,1,0,1,854,854,0.42857
0,0,1,1,2,-19,-19,0.71429
480,0,1,1,2,441,441,0.71429
240,0,1,0,1,184,184,0.42857
0,0,1,1,2,57,57,0.71429
840,0,1,0,1,803,803,0.42857
0,3,0,0,1,-4,-7,0.42857
240,-17,0,0,1,191,208,0.42857
0,-25,0,0,4,-21,4,0
0,36,0,0,4,17,-19,0
0,-15,0,0,3,-24,-9,0.14286
0,-11,0,0,3,-30,-19,0.14286
240,9,0,1,1,222,213,0.57143
240,0,1,0,1,290,290,0.42857
480,14,0,1,2,529,515,0.71429
0,-37,0,0,3,-14,23,0.14286
240,23,0,1,3,242,219,0.85714
0,22,0,0,3,-9,-31,0.14286
240,0,1,1,3,232,232,0.85714
480,2,0,1,3,470,468,0.85714
840,0,1,1,3,832,832,0.85714
0,0,1,1,3,-16,-16,0.85714
240,0,1,1,3,236,236,0.85714
480,69,0,0,3,537,468,0.14286
240,0,1,1,3,231,231,0.85714
480,0,1,1,3,502,502,0.85714
840,35,0,0,1,834,799,0.42857
840,12,0,1,2,873,861,0.71429
240,4,0,1,3,238,234,0.85714
0,14,0,0,3,48,34,0.14286
840,18,0,1,2,851,833,0.71429
240,0,1,1,2,214,214,0.71429
0,0,1,0,1,55,55,0.42857
240,56,0,0,4,244,188,0
240,0,1,1,3,278,278,0.85714
0,17,0,0,4,15,-2,0
240,-30,0,1,2,239,269,0.71429
480,0,1,1,2,479,479,0.71429
840,51,0,0,4,884,833,0
240,-9,0,1,3,224,233,0.85714
0,-3,0,1,3,-14,-11,0.85714
480,1,0,1,4,475,474,1
0,0,1,1,3,-23,-23,0.85714
240,0,1,1,3,225,225,0.85714
840,21,0,0,1,863,842,0.42857
840,-21,0,0,1,845,866,0.42857
480,0,1,1,3,456,456,0.85714
0,68,0,0,4,20,-48,0
240,-14,0,1,3,223,237,0.85714
240,0,1,1,3,251,251,0.85714
840,0,1,0,1,817,817,0.42857
480,-1,0,1,3,511,512,0.85714
840,-10,0,1,3,840,850,0.85714
240,13,0,1,3,219,206,0.85714
0,0,1,1,3,12,12,0.85714
840,0,1,1,3,841,841,0.85714
0,0,1,1,3,-44,-44,0.85714
240,52,0,0,4,259,207,0
0,0,1,1,3,-13,-13,0.85714
840,-5,0,1,3,830,835,0.85714
0,51,0,0,4,28,-23,0
0,0,1,1,4,-26,-26,1
840,18,0,0,4,862,844,0
480,9,0,1,3,484,475,0.85714
0,47,0,0,4,48,1,0
480,9,0,1,1,478,469,0.57143
240,-15,0,1,2,218,233,0.71429
480,0,1,1,3,458,458,0.85714
0,15,0,0,1,13,-2,0.42857
840,39,0,0,1,840,801,0.42857
0,17,0,0,1,-29,-46,0.42857
0,-14,0,0,3,1,15,0.14286
0,0,1,1,1,64,64,0.57143
0,0,1,0,3,-14,-14,0.14286
240,0,1,1,2,259,259,0.71429
480,0,1,0,1,490,490,0.42857
840,0,1,1,3,869,869,0.85714
0,-10,0,0,3,1,11,0.14286
840,-2,0,1,1,853,855,0.57143
840,-57,0,0,4,815,872,0
0,2,0,0,1,12,10,0.42857
0,-22,0,0,4,-16,6,0
240,-12,0,0,4,238,250,0
240,-5,0,0,2,226,231,0.28571
480,0,1,0,2,457,457,0.28571
480,3,0,0,2,468,465,0.28571
240,0,1,0,1,252,252,0.42857
480,0,1,0,3,451,451,0.14286
480,-32,0,0,3,479,511,0.14286
240,14,0,0,1,239,225,0.42857
480,0,1,0,1,485,485,0.42857
240,0,1,0,1,226,226,0.42857
840,7,0,1,1,818,811,0.57143
240,35,0,0,4,291,256,0
0,0,1,1,3,38,38,0.85714
480,0,1,0,1,511,511,0.42857
0,0,1,0,1,20,20,0.42857
480,0,1,1,2,490,490,0.71429
240,0,1,0,1,260,260,0.42857
0,-16,0,0,4,-20,-4,0
480,0,1,1,1,473,473,0.57143
480,-51,0,0,2,487,538,0.28571
240,0,1,1,1,257,257,0.57143
480,-22,0,1,1,489,511,0.57143
480,0,1,0,1,470,470,0.42857
840,-56,0,0,4,780,836,0
0,0,1,1,1,44,44,0.57143
840,93,0,0,4,901,808,0
0,0,1,1,1,20,20,0.57143
840,-24,0,0,1,832,856,0.42857
840,0,1,0,3,860,860,0.14286
480,-6,0,0,1,468,474,0.42857
240,0,1,0,2,218,218,0.28571
840,0,1,0,1,766,766,0.42857
240,-16,0,1,2,234,250,0.71429
240,12,0,0,1,262,250,0.42857
480,-11,0,0,1,460,471,0.42857
0,19,0,0,4,11,-8,0
840,0,1,0,2,832,832,0.28571
840,-59,0,0,2,827,886,0.28571
240,0,1,1,2,233,233,0.71429
480,36,0,0,1,502,466,0.42857
840,0,1,1,2,818,818,0.71429
0,-28,0,0,4,-18,10,0
840,-30,0,0,4,855,885,0
240,0,1,1,2,248,248,0.71429
480,-2,0,0,1,477,479,0.42857
840,38,0,0,1,858,820,0.42857
480,44,0,0,1,508,464,0.42857
840,0,1,1,1,803,803,0.57143
840,-49,0,0,1,804,853,0.42857
480,3,0,0,1,484,481,0.42857
0,88,0,0,4,85,-3,0
240,0,1,0,1,186,186,0.42857
840,31,0,0,1,853,822,0.42857
240,0,1,1,3,258,258,0.85714
480,-17,0,1,3,486,503,0.85714
840,-27,0,0,1,823,850,0.42857
840,27,0,0,1,848,821,0.42857
240,0,1,0,1,268,268,0.42857
240,-37,0,0,3,194,231,0.14286
840,-50,0,0,2,809,859,0.28571
240,0,1,1,2,231,231,0.71429
240,0,1,1,3,225,225,0.85714
0,-6,0,0,1,12,18,0.42857
840,-2,0,1,2,857,859,0.71429
0,13,0,0,4,7,-6,0
0,-43,0,0,4,-18,25,0
480,-26,0,1,3,483,509,0.85714
480,0,1,1,3,484,484,0.85714
840,0,1,0,1,841,841,0.42857
480,-37,0,1,3,446,483,0.85714
840,0,1,0,1,838,838,0.42857
840,0,1,0,1,863,863,0.42857
840,-32,0,0,1,803,835,0.42857
480,-51,0,0,1,434,485,0.42857
840,0,1,0,2,846,846,0.28571
240,50,0,0,3,303,253,0.14286
240,0,1,0,3,278,278,0.14286
240,30,0,0,3,255,225,0.14286
840,0,1,1,1,832,832,0.57143
240,0,1,0,3,235,235,0.14286
480,0,1,0,3,497,497,0.14286
0,-2,0,0,2,2,4,0.28571
240,0,1,1,2,253,253,0.71429
480,20,0,0,3,505,485,0.14286
0,0,1,1,1,17,17,0.57143
840,30,0,0,3,872,842,0.14286
840,0,1,0,3,826,826,0.14286
0,-14,0,0,4,-33,-19,0
0,-36,0,0,4,-42,-6,0
0,0,1,1,3,3,3,0.85714
240,24,0,0,3,277,253,0.14286
0,0,1,1,2,4,4,0.71429
840,0,1,1,1,865,865,0.57143
240,0,1,1,3,251,251,0.85714
840,0,1,0,1,907,907,0.42857
0,-25,0,0,3,-7,18,0.14286
840,-44,0,1,2,806,850,0.71429
480,-9,0,1,3,454,463,0.85714
240,0,1,1,3,216,216,0.85714
240,0,1,1,3,236,236,0.85714
240,0,1,1,3,204,204,0.85714
0,0,1,1,4,-4,-4,1
240,37,0,0,3,238,201,0.14286
840,0,1,0,2,837,837,0.28571
840,-26,0,0,1,805,831,0.42857
0,0,1,1,3,-33,-33,0.85714
0,26,0,0,3,40,14,0.14286
0,0,1,1,4,10,10,1
840,0,1,0,1,801,801,0.42857
0,0,1,0,1,-7,-7,0.42857
0,0,1,1,1,-28,-28,0.57143
840,0,1,0,2,813,813,0.28571
480,0,1,1,1,497,497,0.57143
0,0,1,1,1,-53,-53,0.57143
840,-51,0,0,1,808,859,0.42857
840,-13,0,0,1,842,855,0.42857
480,0,1,1,2,446,446,0.71429
0,49,0,0,4,27,-22,0
240,-6,0,1,1,209,215,0.57143
840,15,0,1,2,855,840,0.71429
480,0,1,1,2,480,480,0.71429
240,0,1,1,2,244,244,0.71429
480,0,1,1,3,471,471,0.85714
840,0,1,1,3,848,848,0.85714
480,-25,0,0,1,456,481,0.42857
480,-35,0,0,3,455,490,0.14286
840,0,1,1,2,831,831,0.71429
240,-41,0,0,4,214,255,0
0,0,1,1,2,41,41,0.71429
480,0,1,0,1,490,490,0.42857
480,0,1,1,1,479,479,0.57143
840,0,1,1,2,780,780,0.71429
0,0,1,1,3,-52,-52,0.85714
240,-1,0,1,3,230,231,0.85714
240,10,0,0,1,257,247,0.42857
0,-9,0,0,4,15,24,0
840,-60,0,1,2,825,885,0.71429
240,-62,0,0,4,209,271,0
0,15,0,0,4,31,16,0
240,-41,0,0,4,239,280,0
480,0,1,1,2,510,510,0.71429
840,9,0,0,2,859,850,0.28571
240,0,1,1,3,251,251,0.85714
0,0,1,1,4,-13,-13,1
480,0,1,1,4,466,466,1
0,-48,0,0,4,-36,12,0
240,-8,0,1,2,246,254,0.71429
240,-2,0,1,2,248,250,0.71429
240,-14,0,1,2,202,216,0.71429
840,0,1,1,2,798,798,0.71429
240,0,1,1,2,242,242,0.71429
0,0,1,1,2,-4,-4,0.71429
840,10,0,1,2,843,833,0.71429
840,3,0,1,2,835,832,0.71429
840,0,1,0,1,837,837,0.42857
840,0,1,1,2,814,814,0.71429
840,0,1,1,2,793,793,0.71429
480,42,0,0,4,511,469,0
0,19,0,0,4,30,11,0
0,0,1,0,4,-16,-16,0
240,18,0,0,4,250,232,0
0,36,0,0,4,26,-10,0
480,-47,0,1,1,465,512,0.57143
0,0,1,1,1,-5,-5,0.57143
240,0,1,1,2,222,222,0.71429
480,0,1,1,2,471,471,0.71429
0,38,0,0,4,15,-23,0
240,-1,0,1,3,253,254,0.85714
480,0,1,1,3,494,494,0.85714
840,0,1,1,3,835,835,0.85714
0,0,1,0,4,41,41,0
240,0,1,0,4,236,236,0
240,44,0,0,4,284,240,0
0,0,1,0,4,10,10,0
240,0,1,0,4,239,239,0
840,7,0,1,1,847,840,0.57143
480,0,1,0,1,474,474,0.42857
0,52,0,0,4,6,-46,0
0,0,1,0,2,-16,-16,0.28571
480,-36,0,1,1,469,505,0.57143
0,-5,0,0,4,-12,-7,0
240,0,1,1,2,226,226,0.71429
0,0,1,1,1,-21,-21,0.57143
0,-13,0,0,4,-2,11,0
840,-8,0,0,4,849,857,0
240,-17,0,1,2,252,269,0.71429
240,-19,0,0,1,231,250,0.42857
480,0,1,1,2,495,495,0.71429
840,-27,0,1,1,799,826,0.57143
480,68,0,0,4,516,448,0
480,0,1,0,4,468,468,0
480,0,1,1,1,480,480,0.57143
0,-55,0,0,4,-40,15,0
840,-28,0,0,1,829,857,0.42857
240,7,0,1,1,232,225,0.57143
0,0,1,1,1,9,9,0.57143
840,0,1,1,2,843,843,0.71429
480,-17,0,1,2,473,490,0.71429
480,-9,0,1,3,463,472,0.85714
840,-8,0,1,3,813,821,0.85714
840,41,0,0,1,874,833,0.42857
480,0,1,0,4,490,490,0
240,0,1,1,1,251,251,0.57143
240,18,0,1,2,243,225,0.71429
480,0,1,1,3,462,462,0.85714
240,-41,0,0,4,235,276,0
240,-32,0,0,4,202,234,0
0,-35,0,0,4,20,55,0
840,58,0,1,1,889,831,0.57143
840,0,1,0,1,863,863,0.42857
0,0,1,1,3,-53,-53,0.85714
840,0,1,1,1,821,821,0.57143
0,16,0,0,4,8,-8,0
240,9,0,0,4,254,245,0
480,0,1,1,1,486,486,0.57143
0,33,0,0,4,0,-33,0
0,0,1,1,2,-2,-2,0.71429
0,0,1,0,4,12,12,0
480,-35,0,1,3,462,497,0.85714
840,0,1,1,3,856,856,0.85714
840,48,0,1,2,870,822,0.71429
840,-67,0,0,4,772,839,0
480,0,1,1,3,507,507,0.85714
0,0,1,0,1,28,28,0.42857
0,-29,0,0,4,-30,-1,0
480,0,1,1,3,498,498,0.85714
240,-12,0,1,3,227,239,0.85714
480,-45,0,1,2,459,504,0.71429
480,43,0,0,1,519,476,0.42857
0,-10,0,0,3,-27,-17,0.14286
480,0,1,1,1,506,506,0.57143
240,-45,0,1,3,241,286,0.85714
240,58,0,0,4,297,239,0
840,-12,0,1,1,861,873,0.57143
0,0,1,1,1,-28,-28,0.57143
0,0,1,1,2,-20,-20,0.71429
240,-1,0,1,1,254,255,0.57143
480,19,0,0,1,485,466,0.42857
0,-8,0,0,4,-4,4,0
480,12,0,1,1,489,477,0.57143
480,48,0,0,4,488,440,0
480,-45,0,0,2,455,500,0.28571
0,0,1,1,1,0,0,0.57143
240,0,1,0,2,232,232,0.28571
0,-44,0,0,4,6,50,0
480,44,0,0,4,518,474,0
0,0,1,1,1,-7,-7,0.57143
0,0,1,1,1,-56,-56,0.57143
0,0,1,0,4,33,33,0
840,-29,0,0,1,842,871,0.42857
480,-41,0,0,2,449,490,0.28571
480,-10,0,0,3,483,493,0.14286
480,49,0,0,3,521,472,0.14286
840,10,0,0,2,852,842,0.28571
240,-57,0,0,4,209,266,0
480,30,0,0,4,536,506,0
480,0,1,1,1,486,486,0.57143
0,-71,0,0,4,-28,43,0
240,0,1,1,1,218,218,0.57143
0,74,0,0,4,21,-53,0
0,0,1,1,1,45,45,0.57143
840,0,1,1,1,845,845,0.57143
840,0,1,0,1,858,858,0.42857
840,-58,0,0,1,822,880,0.42857
240,0,1,0,2,247,247,0.28571
840,0,1,0,2,893,893,0.28571
240,0,1,1,2,215,215,0.71429
240,0,1,1,2,249,249,0.71429
240,0,1,1,3,250,250,0.85714
840,32,0,1,3,860,828,0.85714
0,0,1,1,3,-6,-6,0.85714
840,0,1,1,3,895,895,0.85714
0,-8,0,1,3,6,14,0.85714
240,0,1,1,4,190,190,1
840,-9,0,1,3,837,846,0.85714
240,-11,0,1,4,256,267,1
240,-33,0,0,1,216,249,0.42857
240,0,1,1,3,283,283,0.85714
480,0,1,1,4,462,462,1
480,0,1,1,4,472,472,1
240,-6,0,1,3,250,256,0.85714
480,31,0,1,4,501,470,1
480,-38,0,0,1,487,525,0.42857
240,0,1,1,2,257,257,0.71429
0,16,0,0,4,21,5,0
480,-23,0,1,3,449,472,0.85714
840,0,1,1,3,839,839,0.85714
480,0,1,1,4,493,493,1
840,0,1,1,4,825,825,1
0,0,1,1,4,-40,-40,1
0,0,1,1,3,-1,-1,0.85714
480,-55,0,1,3,472,527,0.85714
0,-46,0,0,4,-38,8,0
240,0,1,1,1,227,227,0.57143
240,0,1,1,1,214,214,0.57143
240,21,0,1,2,278,257,0.71429
0,0,1,1,2,42,42,0.71429
240,0,1,1,2,211,211,0.71429
240,50,0,0,1,247,197,0.42857
0,0,1,1,3,16,16,0.85714
840,61,0,1,3,885,824,0.85714
480,44,0,0,1,507,463,0.42857
240,0,1,1,1,212,212,0.57143
840,-23,0,1,1,841,864,0.57143
480,-34,0,0,1,460,494,0.42857
840,0,1,0,1,847,847,0.42857
240,0,1,0,1,243,243,0.42857
840,0,1,0,1,832,832,0.42857
480,0,1,1,1,475,475,0.57143
480,-4,0,0,1,484,488,0.42857
840,0,1,0,1,847,847,0.42857
840,0,1,0,1,858,858,0.42857
0,-2,0,1,2,-12,-10,0.71429
480,0,1,1,2,500,500,0.71429
0,-44,0,0,4,-21,23,0
840,0,1,0,1,866,866,0.42857
240,28,0,0,1,276,248,0.42857
480,0,1,0,2,519,519,0.28571
240,-12,0,0,2,257,269,0.28571
480,0,1,0,1,474,474,0.42857
240,69,0,0,4,286,217,0
0,0,1,0,1,18,18,0.42857
840,0,1,0,1,829,829,0.42857
480,0,1,0,1,485,485,0.42857
840,-34,0,1,1,812,846,0.57143
840,8,0,1,1,854,846,0.57143
0,0,1,1,2,10,10,0.71429
0,0,1,1,2,1,1,0.71429
480,27,0,0,2,509,482,0.28571
0,0,1,0,1,19,19,0.42857
240,-51,0,0,4,227,278,0
840,15,0,0,1,829,814,0.42857
240,0,1,1,2,254,254,0.71429
480,0,1,1,1,512,512,0.57143
240,0,1,1,1,222,222,0.57143
480,-5,0,1,2,465,470,0.71429
840,-27,0,1,2,799,826,0.71429
840,0,1,1,2,840,840,0.71429
0,50,0,0,4,3,-47,0
480,0,1,1,2,485,485,0.71429
0,-14,0,1,3,-14,-0,0.85714
480,59,0,1,3,501,442,0.85714
0,0,1,1,3,-10,-10,0.85714
840,-12,0,1,3,852,864,0.85714
240,0,1,0,1,239,239,0.42857
480,0,1,1,1,473,473,0.57143
840,0,1,0,1,862,862,0.42857
240,5,0,1,1,227,222,0.57143
240,0,1,1,1,267,267,0.57143
480,-56,0,0,1,440,496,0.42857
0,0,1,1,1,9,9,0.57143
480,0,1,0,1,428,428,0.42857
840,18,0,0,1,845,827,0.42857
240,0,1,1,1,223,223,0.57143
840,-8,0,1,1,870,878,0.57143
0,0,1,0,1,-32,-32,0.42857
240,0,1,1,1,270,270,0.57143
0,-2,0,1,1,-30,-28,0.57143
840,0,1,1,1,837,837,0.57143
240,0,1,1,1,246,246,0.57143
0,0,1,1,1,-14,-14,0.57143
0,-35,0,0,4,-49,-14,0
840,0,1,0,4,870,870,0
0,0,1,0,2,-6,-6,0.28571
240,0,1,0,4,265,265,0
480,0,1,0,4,483,483,0
0,0,1,0,4,9,9,0
0,81,0,0,4,14,-67,0
840,0,1,0,4,807,807,0
0,0,1,0,1,24,24,0.42857
0,0,1,1,1,-9,-9,0.57143
840,31,0,0,2,864,833,0.28571
240,0,1,1,1,183,183,0.57143
0,4,0,1,2,-7,-11,0.71429
480,-15,0,0,1,468,483,0.42857
840,-32,0,0,1,847,879,0.42857
240,-39,0,0,3,197,236,0.14286
240,0,1,0,1,254,254,0.42857
240,0,1,0,2,230,230,0.28571
0,0,1,1,1,4,4,0.57143
240,15,0,0,1,253,238,0.42857
240,0,1,0,2,212,212,0.28571
480,25,0,1,1,510,485,0.57143
0,11,0,0,1,20,9,0.42857
0,22,0,0,2,23,1,0.28571
480,-7,0,1,1,483,490,0.57143
240,41,0,0,2,264,223,0.28571
840,50,0,0,3,858,808,0.14286
840,51,0,0,1,894,843,0.42857
240,0,1,1,1,202,202,0.57143
840,10,0,0,1,812,802,0.42857
840,0,1,0,1,804,804,0.42857
240,-18,0,1,1,240,258,0.57143
480,0,1,1,1,470,470,0.57143
0,0,1,1,2,-15,-15,0.71429
240,52,0,0,2,274,222,0.28571
480,0,1,1,2,510,510,0.71429
480,70,0,0,3,519,449,0.14286
840,24,0,0,4,833,809,0
840,-17,0,0,4,792,809,0
0,38,0,0,3,21,-17,0.14286
840,-11,0,0,3,840,851,0.14286
480,0,1,1,1,463,463,0.57143
240,15,0,0,2,256,241,0.28571
0,12,0,0,3,5,-7,0.14286
0,-65,0,0,4,-43,22,0
0,54,0,0,4,29,-25,0
0,7,0,0,1,10,3,0.42857
480,0,1,1,1,510,510,0.57143
840,0,1,0,4,850,850,0
840,0,1,0,2,838,838,0.28571
240,17,0,0,1,254,237,0.42857
0,37,0,0,3,36,-1,0.14286
840,28,0,1,1,867,839,0.57143
240,0,1,1,1,231,231,0.57143
480,3,0,1,2,496,493,0.71429
480,0,1,1,2,439,439,0.71429
480,0,1,1,3,477,477,0.85714
0,0,1,0,2,10,10,0.28571
0,7,0,0,3,31,24,0.14286
840,33,0,0,2,871,838,0.28571
0,0,1,0,2,7,7,0.28571
0,-25,0,0,3,-30,-5,0.14286
0,0,1,1,1,-28,-28,0.57143
0,0,1,1,1,-53,-53,0.57143
480,23,0,0,2,496,473,0.28571
0,0,1,1,1,-21,-21,0.57143
480,19,0,0,1,529,510,0.42857
0,0,1,1,1,-19,-19,0.57143
0,59,0,0,2,46,-13,0.28571
0,0,1,1,1,-13,-13,0.57143
240,0,1,1,1,233,233,0.57143
480,0,1,0,2,455,455,0.28571
240,0,1,1,1,232,232,0.57143
480,51,0,0,2,462,411,0.28571
480,0,1,0,2,457,457,0.28571
840,-66,0,0,2,797,863,0.28571
480,0,1,1,1,500,500,0.57143
840,0,1,0,1,838,838,0.42857
0,26,0,0,3,-4,-30,0.14286
480,0,1,0,2,491,491,0.28571
840,-2,0,1,1,846,848,0.57143
480,0,1,0,1,475,475,0.42857
840,0,1,0,2,834,834,0.28571
240,0,1,1,1,267,267,0.57143
840,0,1,1,2,840,840,0.71429
840,15,0,0,2,827,812,0.28571
240,19,0,0,1,280,261,0.42857
480,28,0,1,1,493,465,0.57143
240,9,0,1,1,223,214,0.57143
480,-5,0,1,1,508,513,0.57143
0,41,0,0,2,14,-27,0.28571
840,0,1,0,2,796,796,0.28571
240,-37,0,0,3,224,261,0.14286
840,41,0,0,3,861,820,0.14286
840,0,1,0,1,816,816,0.42857
840,-6,0,1,1,832,838,0.57143
240,14,0,0,1,257,243,0.42857
480,25,0,0,1,479,454,0.42857
240,0,1,0,2,222,222,0.28571
240,0,1,1,2,239,239,0.71429
840,10,0,1,3,860,850,0.85714
480,42,0,0,4,473,431,0
0,-3,0,0,4,13,16,0
240,0,1,0,3,220,220,0.14286
480,0,1,1,2,462,462,0.71429
240,41,0,0,2,233,192,0.28571
840,-27,0,0,3,839,866,0.14286
480,-1,0,0,3,471,472,0.14286
0,0,1,1,1,-15,-15,0.57143
480,0,1,0,2,470,470,0.28571
0,48,0,0,2,13,-35,0.28571
240,0,1,0,3,247,247,0.14286
840,-10,0,0,3,821,831,0.14286
480,0,1,0,3,457,457,0.14286
480,0,1,0,3,502,502,0.14286
840,23,0,0,3,868,845,0.14286
840,25,0,0,3,865,840,0.14286
240,-9,0,1,1,257,266,0.57143
240,0,1,0,2,240,240,0.28571
480,0,1,0,1,421,421,0.42857
0,18,0,0,2,-17,-35,0.28571
0,0,1,0,2,31,31,0.28571
240,0,1,0,3,274,274,0.14286
840,0,1,1,1,826,826,0.57143
480,24,0,0,2,504,480,0.28571
0,-67,0,0,2,-58,9,0.28571
480,0,1,1,1,455,455,0.57143
480,9,0,1,1,466,457,0.57143
840,20,0,0,2,891,871,0.28571
480,0,1,0,2,438,438,0.28571
480,2,0,0,2,475,473,0.28571
0,62,0,0,3,21,-41,0.14286
840,0,1,0,2,836,836,0.28571
840,0,1,0,1,819,819,0.42857
840,0,1,0,1,849,849,0.42857
840,12,0,1,1,839,827,0.57143
840,0,1,1,1,857,857,0.57143
0,-6,0,0,3,11,17,0.14286
840,0,1,0,3,812,812,0.14286
840,-17,0,1,1,823,840,0.57143
0,-22,0,0,3,-31,-9,0.14286
840,16,0,1,1,839,823,0.57143
840,-7,0,0,2,845,852,0.28571
480,58,0,0,2,527,469,0.28571
240,0,1,1,1,226,226,0.57143
240,23,0,0,2,242,219,0.28571
0,-38,0,0,3,-22,16,0.14286
240,0,1,1,1,216,216,0.57143
480,0,1,0,3,430,430,0.14286
240,0,1,0,3,237,237,0.14286
0,0,1,1,1,-20,-20,0.57143
840,-18,0,1,1,845,863,0.57143
240,0,1,0,2,242,242,0.28571
0,0,1,1,1,22,22,0.57143
0,0,1,1,1,22,22,0.57143
480,69,0,0,2,540,471,0.28571
480,0,1,0,3,485,485,0.14286
240,-30,0,1,1,202,232,0.57143
240,-68,0,0,3,197,265,0.14286
480,71,0,0,3,509,438,0.14286
480,0,1,1,1,481,481,0.57143
240,-5,0,0,1,253,258,0.42857
0,0,1,0,2,-8,-8,0.28571
240,30,0,0,2,242,212,0.28571
240,0,1,1,1,223,223,0.57143
0,0,1,1,2,20,20,0.71429
840,0,1,1,2,855,855,0.71429
240,-2,0,0,2,245,247,0.28571
240,-12,0,0,2,225,237,0.28571
840,-8,0,0,3,877,885,0.14286
0,-16,0,0,3,-14,2,0.14286
480,-27,0,1,1,462,489,0.57143
240,0,1,0,2,231,231,0.28571
0,13,0,0,2,-4,-17,0.28571
240,-23,0,0,3,240,263,0.14286
480,0,1,1,1,491,491,0.57143
240,0,1,0,2,262,262,0.28571
240,0,1,1,1,229,229,0.57143
840,0,1,1,2,820,820,0.71429
480,0,1,0,1,446,446,0.42857
480,0,1,1,2,490,490,0.71429
240,-23,0,0,2,256,279,0.28571
480,0,1,1,2,512,512,0.71429
840,28,0,0,2,833,805,0.28571
240,0,1,1,2,195,195,0.71429
840,0,1,0,1,854,854,0.42857
240,25,0,0,1,253,228,0.42857
480,26,0,0,1,472,446,0.42857
480,0,1,0,1,478,478,0.42857
0,-31,0,0,3,2,33,0.14286
240,-41,0,0,3,212,253,0.14286
840,56,0,1,1,891,835,0.57143
0,0,1,1,3,-47,-47,0.85714
480,17,0,1,3,479,462,0.85714
0,0,1,1,4,-22,-22,1
480,0,1,1,3,514,514,0.85714
0,0,1,1,4,8,8,1
480,0,1,1,4,478,478,1
0,0,1,1,4,-18,-18,1
480,16,0,1,4,502,486,1
840,0,1,0,2,840,840,0.28571
240,0,1,1,3,245,245,0.85714
0,22,0,0,3,9,-13,0.14286
240,-24,0,0,2,213,237,0.28571
0,0,1,1,3,5,5,0.85714
0,18,0,0,3,-2,-20,0.14286
840,-7,0,0,2,846,853,0.28571
480,0,1,1,3,477,477,0.85714
840,0,1,0,2,876,876,0.28571
840,0,1,1,3,812,812,0.85714
240,-45,0,0,3,252,297,0.14286
480,71,0,0,3,516,445,0.14286
840,-3,0,0,4,826,829,0
840,30,0,0,4,864,834,0
240,31,0,0,4,230,199,0
240,19,0,0,4,235,216,0
0,32,0,0,4,-2,-34,0
240,-25,0,0,4,207,232,0
0,40,0,0,4,46,6,0
0,-15,0,0,4,26,41,0
840,0,1,1,1,862,862,0.57143
240,0,1,1,1,255,255,0.57143
480,0,1,1,2,506,506,0.71429
240,0,1,1,2,243,243,0.71429
480,-60,0,0,3,461,521,0.14286
480,-11,0,1,1,442,453,0.57143
480,0,1,0,4,469,469,0
840,14,0,0,2,864,850,0.28571
840,0,1,0,1,833,833,0.42857
840,15,0,1,2,838,823,0.71429
480,0,1,1,2,473,473,0.71429
480,0,1,0,2,448,448,0.28571
0,54,0,0,4,29,-25,0
240,0,1,1,3,237,237,0.85714
0,-11,0,0,4,9,20,0
480,6,0,1,4,469,463,1
840,-72,0,0,1,842,914,0.42857
0,-9,0,0,2,12,21,0.28571
240,0,1,0,1,250,250,0.42857
0,0,1,0,1,27,27,0.42857
840,0,1,1,1,857,857,0.57143
840,0,1,0,2,864,864,0.28571
840,-54,0,0,1,824,878,0.42857
480,0,1,0,2,435,435,0.28571
480,25,0,1,1,496,471,0.57143
840,0,1,0,1,822,822,0.42857
840,0,1,0,1,851,851,0.42857
0,2,0,1,2,4,2,0.71429
840,29,0,0,1,861,832,0.42857
240,-13,0,0,2,207,220,0.28571
240,-9,0,0,3,252,261,0.14286
480,0,1,1,3,471,471,0.85714
840,-48,0,0,1,819,867,0.42857
840,0,1,1,2,813,813,0.71429
480,0,1,0,1,468,468,0.42857
240,0,1,1,2,218,218,0.71429
0,-48,0,0,4,-33,15,0
480,-35,0,0,3,474,509,0.14286
480,0,1,1,2,459,459,0.71429
0,0,1,1,3,-39,-39,0.85714
240,17,0,1,3,276,259,0.85714
480,0,1,1,3,490,490,0.85714
240,-10,0,1,4,222,232,1
480,0,1,1,4,466,466,1
840,0,1,1,4,867,867,1
840,12,0,1,4,836,824,1
840,0,1,1,4,859,859,1
0,0,1,1,4,45,45,1
0,0,1,1,4,-42,-42,1
480,18,0,1,4,474,456,1
0,-7,0,1,4,-19,-12,1
840,-4,0,1,4,852,856,1
240,-52,0,0,4,206,258,0
240,0,1,1,4,230,230,1
840,0,1,1,3,837,837,0.85714
480,0,1,1,3,482,482,0.85714
0,0,1,1,3,40,40,0.85714
480,0,1,1,3,441,441,0.85714
480,0,1,1,3,517,517,0.85714
240,2,0,1,2,250,248,0.71429
480,0,1,1,2,475,475,0.71429
240,0,1,1,3,240,240,0.85714
480,0,1,1,3,506,506,0.85714
840,0,1,1,3,868,868,0.85714
240,0,1,1,3,238,238,0.85714
240,-18,0,0,1,236,254,0.42857
840,0,1,0,3,862,862,0.14286
840,0,1,0,1,851,851,0.42857
240,-27,0,0,2,220,247,0.28571
840,0,1,0,2,805,805,0.28571
840,0,1,0,2,855,855,0.28571
840,0,1,0,1,891,891,0.42857
240,22,0,1,1,248,226,0.57143
0,-1,0,1,1,1,2,0.57143
240,-15,0,0,1,243,258,0.42857
0,-48,0,0,3,-15,33,0.14286
0,0,1,1,1,-16,-16,0.57143
480,27,0,1,1,536,509,0.57143
480,23,0,0,2,474,451,0.28571
840,23,0,0,1,867,844,0.42857
0,0,1,0,1,-13,-13,0.42857
240,0,1,1,1,206,206,0.57143
480,49,0,0,2,530,481,0.28571
480,0,1,1,1,505,505,0.57143
0,52,0,0,3,40,-12,0.14286
840,0,1,1,1,853,853,0.57143
240,0,1,1,3,251,251,0.85714
240,0,1,1,3,249,249,0.85714
240,0,1,1,3,208,208,0.85714
0,-29,0,0,3,-32,-3,0.14286
840,23,0,0,2,843,820,0.28571
0,0,1,1,3,-12,-12,0.85714
240,-7,0,1,3,237,244,0.85714
0,52,0,0,3,11,-41,0.14286
0,0,1,1,3,-24,-24,0.85714
240,1,0,1,3,268,267,0.85714
480,0,1,1,4,464,464,1
840,12,0,1,4,842,830,1
0,54,0,0,4,53,-1,0
240,0,1,1,3,251,251,0.85714
840,0,1,0,4,853,853,0
0,-12,0,0,4,45,57,0
240,0,1,1,4,241,241,1
0,47,0,0,4,38,-9,0
840,0,1,1,3,825,825,0.85714
480,0,1,1,3,505,505,0.85714
480,0,1,1,3,471,471,0.85714
840,0,1,1,3,836,836,0.85714
240,0,1,1,3,245,245,0.85714
840,-49,0,1,4,830,879,1
840,0,1,1,4,822,822,1
480,-38,0,1,4,479,517,1
240,0,1,1,4,222,222,1
0,0,1,1,4,-59,-59,1
240,-31,0,1,4,219,250,1
480,21,0,1,4,484,463,1
0,0,1,1,4,46,46,1
0,0,1,1,4,-4,-4,1
480,0,1,0,1,475,475,0.42857
840,-33,0,0,1,813,846,0.42857
240,18,0,1,1,241,223,0.57143
840,16,0,0,1,821,805,0.42857
0,-65,0,0,4,-42,23,0
480,0,1,1,2,495,495,0.71429
840,-3,0,0,1,853,856,0.42857
840,0,1,0,1,854,854,0.42857
480,0,1,1,1,448,448,0.57143
0,-2,0,1,3,15,17,0.85714
240,0,1,1,3,245,245,0.85714
840,0,1,1,4,803,803,1
840,0,1,1,3,812,812,0.85714
0,18,0,1,4,2,-16,1
240,0,1,1,4,210,210,1
840,-42,0,1,4,822,864,1
