0,-24,3,1,4,-18,6,1
840,-13,3,1,1,870,883,0.57143
240,-68,3,1,3,204,272,0.85714
840,0,2,-1,2,845,845,0.28571
480,12,2,-1,1,482,470,0.42857
240,-33,3,1,3,198,231,0.85714
840,-18,3,1,2,807,825,0.71429
0,12,2,-1,1,5,-7,0.42857
480,-9,3,-1,1,506,515,0.42857
240,-16,3,1,3,200,216,0.85714
0,-50,3,1,4,-28,22,1
840,-23,3,1,4,842,865,1
0,-23,3,1,4,-10,13,1
480,-1,3,-1,2,482,483,0.28571
480,3,2,-1,2,493,490,0.28571
0,-29,3,1,4,-21,8,1
0,-27,3,1,4,-5,22,1
480,15,2,-1,3,487,472,0.14286
240,-10,3,1,2,254,264,0.71429
840,-39,3,1,2,823,862,0.71429
0,-78,3,1,4,-31,47,1
240,1,2,-1,2,219,218,0.28571
480,-40,3,1,3,449,489,0.85714
240,63,2,-1,3,270,207,0.14286
840,20,2,-1,3,874,854,0.14286
480,22,2,-1,3,458,436,0.14286
0,-2,3,-1,3,-21,-19,0.14286
0,1,2,-1,3,-10,-11,0.14286
480,-34,3,-1,1,448,482,0.42857
840,51,2,-1,3,867,816,0.14286
840,19,2,-1,3,841,822,0.14286
480,22,2,-1,2,499,477,0.28571
0,-23,3,1,3,-24,-1,0.85714
0,-53,3,1,4,-3,50,1
0,-89,3,1,4,-37,52,1
480,-42,3,1,4,466,508,1
240,7,2,-1,2,250,243,0.28571
480,35,2,-1,2,476,441,0.28571
840,48,2,-1,2,881,833,0.28571
480,8,2,-1,2,477,469,0.28571
0,76,2,-1,4,22,-54,0
840,16,2,-1,2,863,847,0.28571
840,-20,3,1,3,842,862,0.85714
840,3,2,-1,3,836,833,0.14286
240,76,2,-1,3,257,181,0.14286
0,37,2,-1,4,3,-34,0
840,40,2,-1,2,885,845,0.28571
240,38,2,-1,3,266,228,0.14286
240,57,2,-1,3,257,200,0.14286
840,-8,3,-1,2,832,840,0.28571
480,-8,3,1,3,462,470,0.85714
0,-6,3,1,2,-11,-5,0.71429
0,22,2,-1,3,26,4,0.14286
240,-19,3,1,2,264,283,0.71429
0,-33,3,1,4,-12,21,1
0,-14,3,1,4,-29,-15,1
840,23,2,-1,2,854,831,0.28571
480,-53,3,1,1,458,511,0.57143
240,-36,3,1,1,242,278,0.57143
240,-14,3,1,2,197,211,0.71429
840,-28,3,1,1,851,879,0.57143
840,29,2,1,1,850,821,0.57143
240,-11,3,1,1,209,220,0.57143
240,-29,3,1,1,249,278,0.57143
480,5,2,1,1,461,456,0.57143
0,18,2,-1,2,4,-14,0.28571
0,5,2,1,2,-39,-44,0.71429
0,20,2,-1,3,-5,-25,0.14286
240,-26,3,1,2,238,264,0.71429
0,39,2,-1,3,9,-30,0.14286
840,34,2,1,2,864,830,0.71429
480,-19,3,1,2,476,495,0.71429
480,20,2,-1,3,502,482,0.14286
0,36,2,-1,4,40,4,0
0,-21,3,1,4,-31,-10,1
480,-6,3,1,3,513,519,0.85714
0,7,2,-1,3,14,7,0.14286
0,-61,3,1,4,-60,1,1
240,-12,3,1,4,237,249,1
840,76,2,-1,4,881,805,0
0,34,2,-1,4,1,-33,0
840,-8,3,1,3,850,858,0.85714
240,-40,3,1,2,184,224,0.71429
240,-27,3,1,3,200,227,0.85714
0,39,2,-1,3,45,6,0.14286
240,-50,3,1,3,205,255,0.85714
240,-28,3,1,2,239,267,0.71429
0,-27,3,1,2,-29,-2,0.71429
480,53,2,-1,3,512,459,0.14286
240,-54,3,1,3,200,254,0.85714
840,20,2,-1,3,842,822,0.14286
240,42,2,-1,3,279,237,0.14286
480,8,2,1,2,473,465,0.71429
240,30,2,-1,3,246,216,0.14286
0,-27,3,1,2,27,54,0.71429
480,1,2,-1,4,487,486,0
840,-36,3,1,4,826,862,1
0,-12,3,1,3,12,24,0.85714
240,-24,3,1,4,242,266,1
480,-43,3,1,4,437,480,1
840,-48,3,1,4,818,866,1
480,31,2,-1,4,468,437,0
480,-44,3,1,4,485,529,1
840,-3,3,1,4,842,845,1
240,-21,3,1,4,215,236,1
840,35,2,1,3,860,825,0.85714
0,-23,3,1,3,-43,-20,0.85714
840,24,2,-1,3,857,833,0.14286
480,-33,3,1,3,472,505,0.85714
840,-6,3,1,3,818,824,0.85714
840,-29,3,1,3,834,863,0.85714
240,-29,3,1,3,243,272,0.85714
240,0,2,1,4,269,269,1
840,37,2,-1,4,852,815,0
240,-83,3,1,3,188,271,0.85714
840,10,2,-1,3,854,844,0.14286
840,-15,3,1,3,821,836,0.85714
480,2,2,1,2,468,466,0.71429
480,-41,3,1,2,445,486,0.71429
840,-50,3,1,2,794,844,0.71429
840,5,2,-1,1,860,855,0.42857
240,-58,3,1,3,187,245,0.85714
840,7,2,-1,1,829,822,0.42857
480,6,2,-1,1,474,468,0.42857
240,-6,3,1,4,220,226,1
240,-28,3,1,4,233,261,1
480,-27,3,1,4,473,500,1
480,-4,3,1,1,482,486,0.57143
840,-35,3,1,2,824,859,0.71429
240,-18,3,1,1,223,241,0.57143
480,22,2,-1,2,503,481,0.28571
240,-61,3,1,3,219,280,0.85714
480,-25,3,1,4,462,487,1
840,6,2,1,1,839,833,0.57143
0,-17,3,1,2,-31,-14,0.71429
240,20,2,-1,2,250,230,0.28571
480,-31,3,1,3,476,507,0.85714
480,-28,3,1,2,463,491,0.71429
840,13,2,1,1,859,846,0.57143
840,-31,3,1,2,827,858,0.71429
0,-21,3,1,3,-11,10,0.85714
480,31,2,-1,2,481,450,0.28571
0,27,2,-1,3,45,18,0.14286
480,28,2,-1,1,497,469,0.42857
0,-31,3,1,2,4,35,0.71429
0,-45,3,1,3,-63,-18,0.85714
480,-28,3,1,3,454,482,0.85714
480,49,2,-1,3,511,462,0.14286
840,-15,3,1,2,854,869,0.71429
0,67,2,-1,3,32,-35,0.14286
480,16,2,-1,2,484,468,0.28571
840,-31,3,1,2,816,847,0.71429
240,35,2,-1,3,282,247,0.14286
840,23,2,-1,2,869,846,0.28571
0,-1,3,-1,2,8,9,0.28571
840,-19,3,1,3,835,854,0.85714
240,-71,3,1,4,217,288,1
840,13,2,-1,2,864,851,0.28571
480,45,2,-1,3,484,439,0.14286
480,29,2,-1,3,521,492,0.14286
0,22,2,-1,2,6,-16,0.28571
480,-2,3,1,2,461,463,0.71429
480,31,2,-1,3,526,495,0.14286
0,62,2,-1,4,39,-23,0
480,86,2,-1,4,525,439,0
0,-35,3,1,3,-17,18,0.85714
0,7,2,-1,2,30,23,0.28571
480,-24,3,1,2,483,507,0.71429
240,28,2,-1,3,256,228,0.14286
0,21,2,-1,3,0,-21,0.14286
480,-51,3,1,3,476,527,0.85714
480,-46,3,1,2,453,499,0.71429
0,-45,3,1,3,-17,28,0.85714
0,21,2,-1,4,8,-13,0
0,33,2,-1,4,-31,-64,0
840,13,2,-1,1,818,805,0.42857
840,36,2,-1,3,834,798,0.14286
240,0,2,-1,2,244,244,0.28571
480,13,2,-1,2,489,476,0.28571
480,49,2,-1,2,440,391,0.28571
240,-6,3,1,2,218,224,0.71429
480,-14,3,1,2,448,462,0.71429
480,41,2,-1,3,506,465,0.14286
240,11,2,-1,2,282,271,0.28571
240,14,2,-1,2,241,227,0.28571
840,23,2,-1,2,869,846,0.28571
240,-21,3,1,2,246,267,0.71429
840,52,2,-1,2,850,798,0.28571
240,67,2,-1,3,260,193,0.14286
0,11,2,-1,3,-8,-19,0.14286
480,-8,3,1,2,446,454,0.71429
240,6,2,-1,2,245,239,0.28571
240,-5,3,1,2,214,219,0.71429
480,11,2,-1,2,487,476,0.28571
240,-14,3,1,2,219,233,0.71429
0,17,2,-1,2,-21,-38,0.28571
240,14,2,-1,3,243,229,0.14286
240,-52,3,1,3,228,280,0.85714
0,11,2,-1,2,-15,-26,0.28571
840,39,2,-1,3,853,814,0.14286
240,4,2,-1,2,243,239,0.28571
840,30,2,-1,2,843,813,0.28571
0,23,2,-1,2,4,-19,0.28571
240,-26,3,1,3,226,252,0.85714
840,28,2,-1,1,833,805,0.42857
240,-35,3,1,3,213,248,0.85714
480,89,2,-1,3,560,471,0.14286
840,-28,3,1,3,840,868,0.85714
840,11,2,-1,2,851,840,0.28571
0,-43,3,1,3,-29,14,0.85714
240,20,2,-1,3,260,240,0.14286
840,-71,3,1,4,803,874,1
0,17,2,-1,4,15,-2,0
480,-30,3,1,3,444,474,0.85714
0,0,2,1,1,-15,-15,0.57143
0,29,2,-1,3,7,-22,0.14286
240,20,2,-1,3,268,248,0.14286
840,3,2,1,2,853,850,0.71429
840,20,2,-1,2,814,794,0.28571
480,-69,3,1,3,462,531,0.85714
480,2,2,1,2,497,495,0.71429
240,9,2,-1,1,238,229,0.42857
240,25,2,-1,2,253,228,0.28571
240,-9,3,1,2,216,225,0.71429
840,11,2,1,2,834,823,0.71429
0,-21,3,1,3,10,31,0.85714
240,21,2,-1,3,235,214,0.14286
480,-48,3,1,3,441,489,0.85714
240,7,2,-1,2,251,244,0.28571
840,37,2,-1,3,850,813,0.14286
0,15,2,-1,3,14,-1,0.14286
840,-26,3,1,2,842,868,0.71429
480,55,2,-1,3,530,475,0.14286
840,-21,3,1,2,852,873,0.71429
240,-10,3,1,2,232,242,0.71429
0,-24,3,1,3,-29,-5,0.85714
840,-67,3,1,3,799,866,0.85714
480,-15,3,1,1,470,485,0.57143
0,10,2,-1,3,2,-8,0.14286
0,13,2,-1,4,22,9,0
240,0,2,1,2,274,274,0.71429
0,38,2,-1,3,1,-37,0.14286
840,-20,3,1,4,838,858,1
840,-4,3,-1,1,836,840,0.42857
480,-6,3,1,2,482,488,0.71429
240,26,2,-1,3,252,226,0.14286
840,56,2,-1,3,871,815,0.14286
480,35,2,-1,2,499,464,0.28571
480,-74,3,1,3,452,526,0.85714
0,32,2,-1,3,57,25,0.14286
480,-11,3,1,2,485,496,0.71429
0,23,2,-1,3,4,-19,0.14286
480,-39,3,1,3,466,505,0.85714
840,14,2,1,2,846,832,0.71429
0,-9,3,1,3,-6,3,0.85714
840,-19,3,1,2,831,850,0.71429
240,33,2,-1,3,277,244,0.14286
240,-14,3,1,3,197,211,0.85714
480,-7,3,1,2,489,496,0.71429
240,14,2,-1,2,261,247,0.28571
480,-4,3,1,3,488,492,0.85714
480,61,2,-1,3,510,449,0.14286
480,-7,3,1,3,476,483,0.85714
0,32,2,-1,3,-2,-34,0.14286
0,-4,3,1,2,16,20,0.71429
0,5,2,-1,3,5,0,0.14286
240,23,2,-1,3,250,227,0.14286
480,-52,3,1,2,443,495,0.71429
480,-32,3,1,3,478,510,0.85714
0,-11,3,1,2,-13,-2,0.71429
0,-72,3,1,3,-20,52,0.85714
0,70,2,-1,3,39,-31,0.14286
480,-21,3,1,2,465,486,0.71429
840,-4,3,1,2,850,854,0.71429
840,-9,3,1,2,835,844,0.71429
0,80,2,-1,3,26,-54,0.14286
840,20,2,-1,2,845,825,0.28571
480,-25,3,1,3,469,494,0.85714
480,0,2,1,2,504,504,0.71429
240,70,2,-1,3,283,213,0.14286
0,-10,3,1,2,-6,4,0.71429
240,8,2,-1,2,237,229,0.28571
480,-43,3,1,2,471,514,0.71429
240,-3,3,1,2,263,266,0.71429
240,32,2,-1,3,257,225,0.14286
240,-31,3,1,2,256,287,0.71429
840,8,2,1,2,826,818,0.71429
480,-56,3,1,3,457,513,0.85714
840,-76,3,1,4,799,875,1
480,21,2,-1,3,458,437,0.14286
0,18,2,-1,4,-10,-28,0
840,12,2,-1,2,858,846,0.28571
840,-15,3,1,3,848,863,0.85714
240,-17,3,1,2,234,251,0.71429
240,-33,3,1,2,211,244,0.71429
0,-16,3,1,3,2,18,0.85714
480,57,2,-1,3,506,449,0.14286
0,6,2,-1,3,-10,-16,0.14286
480,-30,3,1,2,459,489,0.71429
0,16,2,-1,3,8,-8,0.14286
0,24,2,-1,3,22,-2,0.14286
0,36,2,-1,3,-4,-40,0.14286
480,-67,3,1,3,445,512,0.85714
840,2,2,1,2,833,831,0.71429
0,-28,3,1,3,-24,4,0.85714
480,-15,3,1,3,502,517,0.85714
480,9,2,-1,3,488,479,0.14286
840,-25,3,1,3,821,846,0.85714
240,-35,3,1,3,254,289,0.85714
240,13,2,-1,2,203,190,0.28571
480,-17,3,1,2,483,500,0.71429
840,-1,3,1,2,839,840,0.71429
840,-12,3,1,3,817,829,0.85714
840,-36,3,1,1,811,847,0.57143
480,-32,3,1,2,507,539,0.71429
240,46,2,-1,3,251,205,0.14286
480,77,2,-1,3,518,441,0.14286
480,-22,3,1,2,464,486,0.71429
840,-30,3,1,2,849,879,0.71429
240,21,2,-1,2,258,237,0.28571
0,18,2,-1,3,6,-12,0.14286
840,14,2,-1,2,829,815,0.28571
240,-12,3,1,2,235,247,0.71429
840,33,2,-1,3,832,799,0.14286
840,-18,3,1,2,818,836,0.71429
0,13,2,-1,3,35,22,0.14286
840,46,2,-1,3,845,799,0.14286
840,54,2,-1,3,879,825,0.14286
240,-26,3,1,2,226,252,0.71429
480,29,2,-1,3,479,450,0.14286
240,-29,3,1,3,246,275,0.85714
840,-18,3,1,2,838,856,0.71429
240,-50,3,1,3,209,259,0.85714
240,22,2,-1,3,259,237,0.14286
480,-18,3,1,2,473,491,0.71429
840,2,2,1,2,838,836,0.71429
840,-40,3,1,3,804,844,0.85714
0,19,2,-1,3,26,7,0.14286
480,33,2,-1,3,496,463,0.14286
840,-20,3,1,2,828,848,0.71429
240,-46,3,1,2,241,287,0.71429
240,23,2,-1,2,285,262,0.28571
840,16,2,-1,1,834,818,0.42857
480,55,2,-1,2,504,449,0.28571
0,48,2,-1,3,11,-37,0.14286
840,-30,3,1,3,851,881,0.85714
0,-26,3,1,3,-26,0,0.85714
240,-23,3,1,2,246,269,0.71429
840,-38,3,1,1,817,855,0.57143
0,-10,3,1,3,-11,-1,0.85714
840,-47,3,1,2,837,884,0.71429
0,56,2,-1,4,13,-43,0
0,-28,3,1,4,-18,10,1
0,29,2,-1,4,8,-21,0
0,5,2,-1,4,37,32,0
840,31,2,-1,2,851,820,0.28571
480,21,2,-1,2,491,470,0.28571
240,-54,3,1,3,227,281,0.85714
840,23,2,-1,2,829,806,0.28571
840,-51,3,1,2,777,828,0.71429
480,38,2,-1,3,511,473,0.14286
240,88,2,-1,4,323,235,0
0,-11,3,1,2,-6,5,0.71429
0,20,2,-1,2,12,-8,0.28571
240,14,2,-1,2,270,256,0.28571
840,10,2,-1,2,845,835,0.28571
480,-91,3,1,3,437,528,0.85714
840,12,2,-1,2,851,839,0.28571
480,19,2,-1,2,513,494,0.28571
0,50,2,-1,2,55,5,0.28571
480,-1,3,1,2,457,458,0.71429
480,29,2,-1,2,497,468,0.28571
0,19,2,-1,3,21,2,0.14286
0,-2,3,1,2,13,15,0.71429
0,-12,3,1,1,-18,-6,0.57143
240,6,2,1,1,226,220,0.57143
840,40,2,-1,2,881,841,0.28571
480,-39,3,1,2,445,484,0.71429
480,6,2,-1,2,480,474,0.28571
840,-2,3,1,2,833,835,0.71429
0,-31,3,1,3,-44,-13,0.85714
480,9,2,1,1,499,490,0.57143
840,-24,3,1,2,831,855,0.71429
0,4,2,1,2,3,-1,0.71429
840,-50,3,1,2,851,901,0.71429
240,34,2,-1,3,275,241,0.14286
480,18,2,1,2,475,457,0.71429
0,-8,3,1,3,-6,2,0.85714
480,-31,3,1,3,462,493,0.85714
480,27,2,-1,2,491,464,0.28571
840,-41,3,1,2,806,847,0.71429
240,-12,3,1,2,239,251,0.71429
0,-48,3,1,3,-69,-21,0.85714
840,82,2,-1,3,878,796,0.14286
0,-2,3,1,1,-2,-0,0.57143
0,-24,3,1,3,-15,9,0.85714
240,-35,3,1,3,224,259,0.85714
0,34,2,-1,3,-15,-49,0.14286
240,34,2,-1,4,233,199,0
480,-41,3,1,3,457,498,0.85714
840,21,2,-1,1,856,835,0.42857
840,40,2,-1,1,843,803,0.42857
0,-39,3,1,3,-48,-9,0.85714
480,39,2,-1,2,499,460,0.28571
240,29,2,-1,2,244,215,0.28571
480,2,2,1,2,487,485,0.71429
0,65,2,-1,3,50,-15,0.14286
240,-21,3,1,2,211,232,0.71429
0,1,2,1,2,8,7,0.71429
0,39,2,-1,2,-2,-41,0.28571
240,30,2,-1,3,245,215,0.14286
480,9,2,1,2,471,462,0.71429
840,-76,3,1,3,773,849,0.85714
240,-109,3,1,3,156,265,0.85714
0,-3,3,-1,1,19,22,0.42857
240,18,2,-1,2,263,245,0.28571
0,44,2,-1,2,53,9,0.28571
480,4,2,-1,2,444,440,0.28571
240,-28,3,1,2,259,287,0.71429
0,69,2,-1,3,47,-22,0.14286
480,21,2,-1,2,493,472,0.28571
840,-55,3,1,2,839,894,0.71429
240,-21,3,1,3,241,262,0.85714
240,-18,3,1,2,229,247,0.71429
240,28,2,-1,3,265,237,0.14286
0,19,2,-1,3,37,18,0.14286
480,-10,3,1,2,457,467,0.71429
240,52,2,-1,3,259,207,0.14286
480,50,2,-1,3,492,442,0.14286
840,25,2,-1,3,848,823,0.14286
480,-16,3,1,2,470,486,0.71429
840,-90,3,1,3,794,884,0.85714
480,29,2,-1,3,488,459,0.14286
840,-47,3,1,3,816,863,0.85714
0,-23,3,1,3,-16,7,0.85714
840,-37,3,1,2,842,879,0.71429
240,-51,3,1,3,219,270,0.85714
840,-49,3,1,2,832,881,0.71429
240,-23,3,1,3,218,241,0.85714
840,23,2,-1,3,834,811,0.14286
840,6,2,1,2,847,841,0.71429
840,-3,3,1,2,829,832,0.71429
480,13,2,-1,2,492,479,0.28571
840,19,2,-1,2,860,841,0.28571
0,12,2,-1,3,-8,-20,0.14286
240,1,2,1,2,256,255,0.71429
240,34,2,-1,3,205,171,0.14286
480,0,2,1,2,512,512,0.71429
0,53,2,-1,3,4,-49,0.14286
0,28,2,-1,3,27,-1,0.14286
840,-78,3,1,3,828,906,0.85714
480,9,2,-1,2,500,491,0.28571
840,-38,3,1,2,842,880,0.71429
240,-22,3,1,2,242,264,0.71429
0,38,2,-1,2,11,-27,0.28571
0,-58,3,1,3,-15,43,0.85714
240,-37,3,1,3,229,266,0.85714
0,-39,3,1,3,-5,34,0.85714
0,4,2,-1,2,30,26,0.28571
480,-26,3,-1,2,470,496,0.28571
840,48,2,-1,2,887,839,0.28571
240,24,2,-1,2,247,223,0.28571
240,-21,3,1,2,237,258,0.71429
240,-64,3,1,3,224,288,0.85714
480,-42,3,1,2,460,502,0.71429
240,-24,3,1,3,207,231,0.85714
240,-13,3,1,2,242,255,0.71429
0,5,2,-1,2,-28,-33,0.28571
0,-18,3,1,2,10,28,0.71429
240,48,2,-1,2,263,215,0.28571
840,-6,3,1,2,835,841,0.71429
240,-24,3,1,3,226,250,0.85714
240,2,2,1,2,253,251,0.71429
480,2,2,-1,2,478,476,0.28571
480,21,2,-1,2,499,478,0.28571
480,-20,3,1,2,460,480,0.71429
240,48,2,-1,2,283,235,0.28571
240,-41,3,1,3,216,257,0.85714
240,13,2,-1,2,239,226,0.28571
840,20,2,-1,2,838,818,0.28571
840,41,2,-1,2,850,809,0.28571
240,39,2,-1,3,238,199,0.14286
480,9,2,-1,1,465,456,0.42857
240,13,2,-1,2,232,219,0.28571
480,-14,3,1,1,453,467,0.57143
480,38,2,-1,2,500,462,0.28571
480,-14,3,1,1,468,482,0.57143
0,32,2,-1,1,15,-17,0.42857
240,5,2,-1,1,226,221,0.42857
240,8,2,-1,2,233,225,0.28571
480,31,2,-1,2,493,462,0.28571
0,21,2,-1,2,31,10,0.28571
240,71,2,-1,3,257,186,0.14286
840,-49,3,1,2,798,847,0.71429
240,-16,3,1,1,209,225,0.57143
840,38,2,-1,2,851,813,0.28571
840,46,2,-1,2,867,821,0.28571
480,9,2,1,1,506,497,0.57143
0,-23,3,1,2,12,35,0.71429
240,60,2,-1,3,269,209,0.14286
840,-4,3,1,2,860,864,0.71429
840,22,2,-1,2,844,822,0.28571
0,-5,3,-1,1,-18,-13,0.42857
240,-29,3,1,2,186,215,0.71429
480,-42,3,1,3,440,482,0.85714
840,35,2,-1,2,844,809,0.28571
240,-51,3,1,2,216,267,0.71429
480,-37,3,1,2,475,512,0.71429
480,47,2,-1,3,508,461,0.14286
240,-22,3,1,2,225,247,0.71429
0,-9,3,1,1,-7,2,0.57143
0,48,2,-1,3,8,-40,0.14286
480,30,2,-1,2,489,459,0.28571
480,17,2,-1,2,472,455,0.28571
840,24,2,1,1,829,805,0.57143
840,-8,3,1,1,824,832,0.57143
480,-4,3,-1,2,483,487,0.28571
240,-24,3,1,2,216,240,0.71429
240,-57,3,1,2,193,250,0.71429
240,-48,3,1,2,188,236,0.71429
840,-21,3,1,1,823,844,0.57143
0,-1,3,-1,2,9,10,0.28571
240,65,2,-1,3,279,214,0.14286
0,15,2,-1,3,45,30,0.14286
0,32,2,-1,2,38,6,0.28571
0,-66,3,1,3,-20,46,0.85714
480,-41,3,1,3,439,480,0.85714
840,26,2,-1,2,833,807,0.28571
240,28,2,-1,2,236,208,0.28571
240,-33,3,1,2,252,285,0.71429
840,-68,3,1,3,822,890,0.85714
240,1,2,-1,2,269,268,0.28571
0,81,2,-1,3,18,-63,0.14286
840,-37,3,1,2,826,863,0.71429
240,47,2,-1,3,262,215,0.14286
480,31,2,-1,3,476,445,0.14286
240,11,2,-1,2,238,227,0.28571
840,7,2,-1,2,794,787,0.28571
0,17,2,-1,3,2,-15,0.14286
240,-3,3,1,1,252,255,0.57143
240,7,2,1,1,270,263,0.57143
480,-16,3,1,2,482,498,0.71429
840,-89,3,1,3,798,887,0.85714
840,15,2,-1,2,866,851,0.28571
840,-7,3,-1,1,827,834,0.42857
0,10,2,-1,2,-16,-26,0.28571
840,-58,3,1,2,822,880,0.71429
0,-24,3,1,3,4,28,0.85714
480,73,2,-1,2,534,461,0.28571
480,-40,3,1,2,467,507,0.71429
480,22,2,-1,3,470,448,0.14286
480,-115,3,1,4,416,531,1
240,6,2,1,1,230,224,0.57143
840,79,2,-1,2,882,803,0.28571
0,-6,3,1,2,-10,-4,0.71429
240,19,2,-1,2,216,197,0.28571
840,-20,3,1,2,833,853,0.71429
480,1,2,-1,2,485,484,0.28571
840,7,2,-1,2,816,809,0.28571
840,-29,3,1,2,842,871,0.71429
240,87,2,-1,2,278,191,0.28571
840,38,2,-1,2,847,809,0.28571
240,-36,3,1,2,212,248,0.71429
480,12,2,-1,2,502,490,0.28571
480,-10,3,-1,2,482,492,0.28571
240,-16,3,1,2,245,261,0.71429
0,-51,3,1,3,-24,27,0.85714
240,-40,3,1,3,240,280,0.85714
0,-28,3,1,3,-22,6,0.85714
0,-12,3,1,2,-17,-5,0.71429
0,41,2,-1,3,22,-19,0.14286
480,-28,3,1,2,454,482,0.71429
840,21,2,-1,2,862,841,0.28571
840,0,2,-1,2,860,860,0.28571
240,13,2,-1,2,252,239,0.28571
480,-5,3,-1,2,466,471,0.28571
840,23,2,-1,2,881,858,0.28571
0,29,2,-1,3,26,-3,0.14286
240,-11,3,1,1,234,245,0.57143
480,22,2,-1,2,491,469,0.28571
240,23,2,-1,2,245,222,0.28571
0,15,2,-1,2,15,-0,0.28571
840,1,2,1,2,820,819,0.71429
840,77,2,-1,3,883,806,0.14286
0,9,2,-1,3,19,10,0.14286
0,-9,3,1,1,-22,-13,0.57143
840,11,2,-1,2,850,839,0.28571
0,12,2,-1,3,8,-4,0.14286
0,49,2,-1,4,50,1,0
840,-43,3,1,1,825,868,0.57143
0,17,2,-1,2,14,-3,0.28571
0,47,2,-1,3,26,-21,0.14286
840,-28,3,1,1,805,833,0.57143
240,-22,3,1,1,201,223,0.57143
480,2,2,-1,2,479,477,0.28571
240,84,2,-1,2,320,236,0.28571
240,4,2,1,1,236,232,0.57143
840,56,2,-1,3,861,805,0.14286
480,-12,3,-1,2,474,486,0.28571
480,22,2,-1,1,485,463,0.42857
240,-2,3,1,1,220,222,0.57143
240,-8,3,1,2,246,254,0.71429
480,-5,3,1,1,458,463,0.57143
480,9,2,1,2,486,477,0.71429
240,32,2,-1,2,239,207,0.28571
240,-23,3,1,2,213,236,0.71429
480,-12,3,1,2,438,450,0.71429
0,48,2,-1,3,26,-22,0.14286
480,-71,3,1,3,451,522,0.85714
0,29,2,-1,3,25,-4,0.14286
0,28,2,-1,3,32,4,0.14286
240,-34,3,1,3,203,237,0.85714
240,-17,3,1,2,253,270,0.71429
240,17,2,-1,2,246,229,0.28571
840,-10,3,1,2,825,835,0.71429
0,-20,3,1,3,-40,-20,0.85714
480,8,2,-1,3,472,464,0.14286
840,-26,3,1,2,845,871,0.71429
240,70,2,-1,2,289,219,0.28571
840,-71,3,1,3,814,885,0.85714
240,54,2,-1,2,254,200,0.28571
840,27,2,-1,2,866,839,0.28571
240,2,2,1,3,230,228,0.85714
0,-13,3,1,3,-11,2,0.85714
840,-33,3,1,2,831,864,0.71429
0,39,2,-1,3,19,-20,0.14286
840,32,2,1,3,873,841,0.85714
0,-23,3,1,3,1,24,0.85714
240,39,2,-1,2,281,242,0.28571
480,29,2,-1,2,507,478,0.28571
840,84,2,-1,2,881,797,0.28571
840,-14,3,1,2,843,857,0.71429
480,-13,3,1,1,470,483,0.57143
240,-26,3,1,2,207,233,0.71429
240,-16,3,1,2,248,264,0.71429
240,-18,3,1,2,256,274,0.71429
480,-6,3,1,2,489,495,0.71429
480,38,2,-1,2,489,451,0.28571
0,-3,3,1,2,-18,-15,0.71429
240,2,2,1,2,254,252,0.71429
480,23,2,-1,3,481,458,0.14286
480,31,2,-1,2,467,436,0.28571
0,-22,3,1,2,-38,-16,0.71429
0,-17,3,1,3,5,22,0.85714
840,31,2,-1,2,869,838,0.28571
0,46,2,-1,3,7,-39,0.14286
480,-35,3,1,2,442,477,0.71429
840,4,2,-1,2,851,847,0.28571
0,9,2,-1,2,5,-4,0.28571
480,-47,3,1,3,439,486,0.85714
480,-34,3,1,2,468,502,0.71429
0,-44,3,1,3,-29,15,0.85714
0,-27,3,1,3,4,31,0.85714
840,-19,3,1,2,860,879,0.71429
480,-9,3,1,2,450,459,0.71429
840,-48,3,-1,2,839,887,0.28571
0,-16,3,1,3,6,22,0.85714
840,2,2,-1,1,827,825,0.42857
480,4,2,-1,1,472,468,0.42857
0,20,2,-1,3,1,-19,0.14286
840,54,2,-1,2,856,802,0.28571
240,-35,3,1,3,222,257,0.85714
480,-44,3,1,2,438,482,0.71429
0,-16,3,1,3,-59,-43,0.85714
0,-29,3,1,3,-43,-14,0.85714
840,-56,3,1,2,813,869,0.71429
480,-50,3,1,3,462,512,0.85714
480,-19,3,1,2,486,505,0.71429
840,44,2,-1,2,886,842,0.28571
0,30,2,-1,2,8,-22,0.28571
0,-35,3,1,3,-7,28,0.85714
480,-20,3,1,2,434,454,0.71429
0,13,2,-1,3,15,2,0.14286
480,-38,3,1,2,447,485,0.71429
240,-12,3,1,2,232,244,0.71429
480,-44,3,1,2,437,481,0.71429
0,-38,3,1,3,5,43,0.85714
0,-56,3,1,3,-11,45,0.85714
840,60,2,-1,3,892,832,0.14286
0,45,2,-1,3,26,-19,0.14286
240,17,2,-1,2,266,249,0.28571
0,-63,3,1,3,-56,7,0.85714
840,9,2,-1,3,853,844,0.14286
240,31,2,-1,2,248,217,0.28571
480,-29,3,1,2,473,502,0.71429
0,28,2,-1,2,32,4,0.28571
240,-45,3,1,2,219,264,0.71429
840,8,2,-1,2,834,826,0.28571
240,-26,3,1,3,204,230,0.85714
480,20,2,-1,2,489,469,0.28571
0,-3,3,1,2,3,6,0.71429
840,0,2,-1,2,843,843,0.28571
480,-73,3,1,2,420,493,0.71429
480,0,2,-1,3,458,458,0.14286
840,39,2,-1,2,851,812,0.28571
840,-6,3,-1,2,817,823,0.28571
0,15,2,1,2,8,-7,0.71429
0,-62,3,1,3,-23,39,0.85714
0,-4,3,-1,1,27,31,0.42857
840,-11,3,-1,1,834,845,0.42857
240,50,2,-1,2,254,204,0.28571
840,-24,3,1,2,851,875,0.71429
840,-24,3,1,2,836,860,0.71429
0,0,2,-1,3,-12,-12,0.14286
480,23,2,-1,3,489,466,0.14286
240,-51,3,1,3,206,257,0.85714
240,-44,3,1,3,213,257,0.85714
0,-2,3,-1,2,7,9,0.28571
240,6,2,1,2,235,229,0.71429
840,-33,3,1,1,826,859,0.57143
0,-12,3,1,2,-6,6,0.71429
840,99,2,-1,2,850,751,0.28571
240,35,2,-1,2,231,196,0.28571
480,14,2,-1,2,465,451,0.28571
480,30,2,-1,2,486,456,0.28571
840,5,2,-1,1,829,824,0.42857
480,48,2,-1,1,528,480,0.42857
480,-34,3,1,2,476,510,0.71429
240,-19,3,1,2,228,247,0.71429
480,-8,3,1,2,470,478,0.71429
240,-34,3,1,3,214,248,0.85714
480,13,2,-1,2,476,463,0.28571
480,60,2,-1,2,508,448,0.28571
0,-40,3,1,3,-30,10,0.85714
840,11,2,-1,3,826,815,0.14286
0,-32,3,1,2,-19,13,0.71429
0,-25,3,1,3,-19,6,0.85714
0,22,2,-1,4,5,-17,0
480,-68,3,1,4,417,485,1
480,61,2,-1,2,489,428,0.28571
240,-16,3,1,2,193,209,0.71429
240,0,2,1,3,238,238,0.85714
0,-27,3,1,2,12,39,0.71429
840,24,2,-1,3,880,856,0.14286
0,-19,3,1,3,9,28,0.85714
480,14,2,-1,2,479,465,0.28571
840,62,2,-1,3,904,842,0.14286
840,27,2,-1,2,845,818,0.28571
240,50,2,-1,2,268,218,0.28571
840,5,2,-1,2,839,834,0.28571
480,14,2,-1,2,500,486,0.28571
840,-29,3,-1,2,799,828,0.28571
240,21,2,-1,2,261,240,0.28571
840,17,2,-1,2,829,812,0.28571
0,29,2,-1,2,12,-17,0.28571
0,10,2,-1,3,-4,-14,0.14286
840,15,2,-1,2,822,807,0.28571
240,23,2,-1,2,282,259,0.28571
840,-23,3,-1,1,828,851,0.42857
480,28,2,-1,2,482,454,0.28571
0,3,2,-1,2,-1,-4,0.28571
480,0,2,-1,2,491,491,0.28571
0,-50,3,1,3,-33,17,0.85714
840,-1,3,1,2,824,825,0.71429
480,-14,3,-1,1,470,484,0.42857
0,-22,3,1,3,-24,-2,0.85714
840,2,2,1,2,855,853,0.71429
480,6,2,1,3,476,470,0.85714
240,-11,3,1,2,238,249,0.71429
0,-36,3,1,3,-1,35,0.85714
480,-21,3,1,2,470,491,0.71429
240,-3,3,1,2,240,243,0.71429
240,-5,3,1,1,204,209,0.57143
840,33,2,-1,1,860,827,0.42857
240,-41,3,1,2,223,264,0.71429
480,26,2,-1,2,502,476,0.28571
0,-9,3,1,2,-9,0,0.71429
480,-41,3,1,3,483,524,0.85714
0,-19,3,1,3,-40,-21,0.85714
240,-12,3,1,2,237,249,0.71429
480,-6,3,1,2,459,465,0.71429
240,0,2,1,2,226,226,0.71429
240,24,2,-1,2,250,226,0.28571
480,-14,3,1,2,475,489,0.71429
840,-41,3,1,2,806,847,0.71429
240,-48,3,1,3,232,280,0.85714
840,-44,3,1,2,809,853,0.71429
240,0,2,-1,1,240,240,0.42857
840,-72,3,1,2,783,855,0.71429
480,14,2,-1,2,451,437,0.28571
840,-25,3,1,1,832,857,0.57143
240,-39,3,1,1,233,272,0.57143
840,27,2,-1,2,841,814,0.28571
480,9,2,-1,2,487,478,0.28571
240,3,2,-1,2,231,228,0.28571
840,35,2,-1,1,851,816,0.42857
0,40,2,-1,3,28,-12,0.14286
840,15,2,-1,2,829,814,0.28571
840,14,2,-1,1,822,808,0.42857
0,27,2,-1,3,11,-16,0.14286
480,17,2,-1,1,510,493,0.42857
480,-10,3,1,1,476,486,0.57143
840,-18,3,-1,1,839,857,0.42857
240,17,2,-1,1,243,226,0.42857
480,24,2,-1,2,485,461,0.28571
840,16,2,-1,1,845,829,0.42857
240,-18,3,1,1,261,279,0.57143
0,4,2,-1,1,1,-3,0.42857
840,31,2,-1,1,843,812,0.42857
240,-37,3,1,2,243,280,0.71429
840,-20,3,1,1,859,879,0.57143
240,-38,3,1,2,210,248,0.71429
480,-16,3,1,2,466,482,0.71429
840,7,2,-1,1,828,821,0.42857
0,30,2,-1,2,7,-23,0.28571
840,-23,3,1,1,817,840,0.57143
0,-18,3,1,2,-32,-14,0.71429
480,22,2,-1,2,474,452,0.28571
0,-38,3,1,3,-17,21,0.85714
480,6,2,1,2,456,450,0.71429
0,-24,3,1,3,13,37,0.85714
0,-24,3,1,4,-10,14,1
480,4,2,-1,3,490,486,0.14286
0,39,2,-1,3,23,-16,0.14286
480,-10,3,1,1,459,469,0.57143
0,9,2,-1,1,4,-5,0.42857
240,-21,3,1,2,218,239,0.71429
840,78,2,-1,2,887,809,0.28571
480,-6,3,1,1,473,479,0.57143
0,-48,3,1,3,5,53,0.85714
480,-32,3,1,3,468,500,0.85714
840,-51,3,1,2,783,834,0.71429
480,75,2,-1,3,550,475,0.14286
0,35,2,-1,4,-6,-41,0
240,1,2,-1,1,247,246,0.42857
840,-6,3,-1,1,831,837,0.42857
240,-40,3,1,2,242,282,0.71429
480,-4,3,1,2,467,471,0.71429
0,4,2,-1,3,21,17,0.14286
0,89,2,-1,4,42,-47,0
240,-10,3,-1,1,224,234,0.42857
240,-7,3,1,1,246,253,0.57143
240,-66,3,1,2,215,281,0.71429
240,23,2,-1,3,252,229,0.14286
240,-5,3,-1,2,218,223,0.28571
480,-5,3,-1,1,485,490,0.42857
480,27,2,-1,2,508,481,0.28571
840,24,2,-1,2,880,856,0.28571
0,-2,3,-1,1,0,2,0.42857
840,45,2,-1,2,868,823,0.28571
0,11,2,-1,2,-17,-28,0.28571
840,-10,3,-1,2,848,858,0.28571
0,34,2,-1,3,30,-4,0.14286
480,-29,3,1,2,449,478,0.71429
240,-12,3,1,3,225,237,0.85714
240,16,2,-1,2,245,229,0.28571
0,22,2,-1,3,16,-6,0.14286
240,11,2,-1,2,250,239,0.28571
240,37,2,-1,2,261,224,0.28571
840,24,2,-1,3,858,834,0.14286
480,-30,3,1,2,464,494,0.71429
0,-23,3,1,2,-38,-15,0.71429
0,-30,3,1,3,23,53,0.85714
840,24,2,-1,2,836,812,0.28571
480,56,2,-1,2,517,461,0.28571
240,8,2,1,3,262,254,0.85714
240,-6,3,1,3,265,271,0.85714
240,-36,3,1,2,237,273,0.71429
0,-16,3,1,3,-45,-29,0.85714
0,46,2,-1,2,24,-22,0.28571
240,-97,3,1,3,176,273,0.85714
480,-22,3,1,2,443,465,0.71429
480,33,2,-1,2,508,475,0.28571
0,-23,3,1,3,10,33,0.85714
240,-16,3,1,2,205,221,0.71429
480,-5,3,1,3,494,499,0.85714
840,-18,3,1,1,835,853,0.57143
0,-43,3,1,3,13,56,0.85714
240,25,2,-1,2,274,249,0.28571
240,25,2,-1,2,242,217,0.28571
480,-44,3,1,2,477,521,0.71429
840,34,2,-1,2,857,823,0.28571
840,17,2,-1,2,847,830,0.28571
0,19,2,-1,2,2,-17,0.28571
840,27,2,-1,2,846,819,0.28571
240,15,2,-1,2,279,264,0.28571
840,72,2,-1,2,853,781,0.28571
480,-12,3,1,2,495,507,0.71429
0,-46,3,1,3,-8,38,0.85714
0,3,2,-1,2,-4,-7,0.28571
840,-14,3,-1,2,828,842,0.28571
480,-41,3,1,2,462,503,0.71429
840,2,2,1,3,839,837,0.85714
240,17,2,-1,1,269,252,0.42857
840,4,2,-1,1,821,817,0.42857
840,-17,3,1,2,840,857,0.71429
480,30,2,-1,2,519,489,0.28571
840,-50,3,1,2,815,865,0.71429
840,14,2,-1,2,818,804,0.28571
480,-35,3,1,2,447,482,0.71429
480,25,2,-1,3,510,485,0.14286
240,-39,3,1,3,253,292,0.85714
840,-9,3,-1,2,842,851,0.28571
0,37,2,-1,2,7,-30,0.28571
0,-9,3,1,3,25,34,0.85714
0,14,2,-1,3,5,-9,0.14286
480,-37,3,1,2,473,510,0.71429
0,-46,3,1,3,-51,-5,0.85714
240,-41,3,1,3,210,251,0.85714
0,21,2,-1,2,10,-11,0.28571
480,32,2,-1,2,510,478,0.28571
0,-26,3,1,3,-15,11,0.85714
840,18,2,-1,2,866,848,0.28571
480,-9,3,1,2,468,477,0.71429
480,53,2,-1,2,483,430,0.28571
0,-63,3,1,3,-27,36,0.85714
240,-35,3,1,3,211,246,0.85714
0,24,2,-1,2,11,-13,0.28571
840,-17,3,1,2,839,856,0.71429
840,12,2,-1,2,850,838,0.28571
0,28,2,-1,2,14,-14,0.28571
240,-27,3,1,3,213,240,0.85714
0,32,2,-1,3,6,-26,0.14286
0,-2,3,-1,1,6,8,0.42857
480,-16,3,1,2,497,513,0.71429
840,17,2,-1,2,850,833,0.28571
480,13,2,-1,1,474,461,0.42857
240,-43,3,1,2,240,283,0.71429
840,52,2,-1,2,857,805,0.28571
840,-4,3,-1,1,821,825,0.42857
480,23,2,-1,1,500,477,0.42857
0,36,2,-1,2,11,-25,0.28571
480,-25,3,1,2,487,512,0.71429
840,19,2,-1,3,852,833,0.14286
240,50,2,-1,2,257,207,0.28571
840,-16,3,1,1,820,836,0.57143
840,34,2,-1,2,872,838,0.28571
840,-5,3,-1,1,833,838,0.42857
240,-9,3,-1,2,260,269,0.28571
480,32,2,-1,1,517,485,0.42857
240,3,2,-1,1,250,247,0.42857
480,15,2,-1,1,517,502,0.42857
240,-22,3,1,1,237,259,0.57143
0,-33,3,1,3,-46,-13,0.85714
480,-10,3,1,2,480,490,0.71429
480,15,2,-1,2,501,486,0.28571
0,22,2,-1,3,20,-2,0.14286
240,-31,3,1,2,221,252,0.71429
240,-24,3,1,3,232,256,0.85714
240,5,2,-1,2,240,235,0.28571
240,-20,3,1,2,223,243,0.71429
840,25,2,-1,2,833,808,0.28571
480,31,2,-1,2,513,482,0.28571
480,-55,3,-1,1,468,523,0.42857
240,-13,3,1,2,248,261,0.71429
0,29,2,-1,2,3,-26,0.28571
240,-21,3,1,3,247,268,0.85714
480,29,2,-1,3,506,477,0.14286
0,-25,3,1,2,-20,5,0.71429
0,8,2,-1,2,8,-0,0.28571
480,31,2,-1,3,501,470,0.14286
240,7,2,-1,2,223,216,0.28571
240,-5,3,-1,3,234,239,0.14286
840,8,2,-1,2,836,828,0.28571
0,-23,3,1,3,-21,2,0.85714
240,-9,3,1,3,240,249,0.85714
840,28,2,-1,2,875,847,0.28571
480,45,2,-1,2,525,480,0.28571
0,-29,3,1,3,-26,3,0.85714
840,-50,3,1,2,813,863,0.71429
