0,0,1,1,2,-12,-12,0.71429
480,0,1,1,2,492,492,0.71429
840,0,1,1,2,798,798,0.71429
480,19,0,1,2,496,477,0.71429
480,0,1,1,2,466,466,0.71429
840,-41,0,0,2,829,870,0.28571
480,-24,0,1,2,440,464,0.71429
840,-103,0,0,4,797,900,0
840,43,0,1,2,891,848,0.71429
480,0,1,0,2,438,438,0.28571
480,0,1,0,2,417,417,0.28571
840,0,1,0,3,822,822,0.14286
840,-40,0,0,3,813,853,0.14286
0,0,1,0,4,16,16,0
0,0,1,0,1,16,16,0.42857
840,0,1,0,2,884,884,0.28571
240,30,0,0,2,259,229,0.28571
840,0,1,0,2,842,842,0.28571
840,21,0,1,1,863,842,0.57143
480,-38,0,0,2,467,505,0.28571
0,-39,0,0,4,-12,27,0
240,-17,0,1,1,228,245,0.57143
840,-10,0,0,1,840,850,0.42857
480,10,0,1,1,519,509,0.57143
480,49,0,1,2,495,446,0.71429
840,21,0,1,2,856,835,0.71429
840,-50,0,0,2,826,876,0.28571
0,-51,0,0,4,-44,7,0
0,0,1,1,1,-13,-13,0.57143
240,11,0,1,2,251,240,0.71429
0,0,1,1,4,7,7,1
840,0,1,0,2,823,823,0.28571
840,0,1,1,2,864,864,0.71429
240,23,0,1,2,251,228,0.71429
240,46,0,0,4,280,234,0
240,0,1,1,2,258,258,0.71429
840,0,1,0,1,860,860,0.42857
480,0,1,1,2,479,479,0.71429
840,0,1,1,2,851,851,0.71429
480,-44,0,0,2,410,454,0.28571
480,0,1,0,1,478,478,0.42857
840,-26,0,1,1,830,856,0.57143
480,-4,0,1,1,477,481,0.57143
240,0,1,1,1,262,262,0.57143
240,36,0,0,1,263,227,0.42857
0,-99,0,0,4,-59,40,0
0,-12,0,0,4,-17,-5,0
0,18,0,0,4,53,35,0
840,0,1,0,1,875,875,0.42857
840,0,1,0,1,823,823,0.42857
480,0,1,0,1,463,463,0.42857
480,0,1,0,1,474,474,0.42857
240,0,1,1,2,248,248,0.71429
480,-8,0,1,2,477,485,0.71429
480,0,1,1,2,470,470,0.71429
840,12,0,1,2,865,853,0.71429
480,0,1,1,2,522,522,0.71429
840,0,1,1,2,879,879,0.71429
480,20,0,1,2,487,467,0.71429
0,11,0,0,2,8,-3,0.28571
240,8,0,1,2,239,231,0.71429
480,16,0,1,2,476,460,0.71429
480,71,0,0,4,499,428,0
480,0,1,0,1,443,443,0.42857
840,-52,0,1,2,814,866,0.71429
240,0,1,1,1,268,268,0.57143
240,29,0,0,1,265,236,0.42857
0,26,0,0,1,37,11,0.42857
0,36,0,0,3,22,-14,0.14286
240,0,1,1,2,272,272,0.71429
840,0,1,0,1,776,776,0.42857
840,0,1,1,1,793,793,0.57143
480,4,0,0,1,493,489,0.42857
480,47,0,0,4,515,468,0
840,0,1,1,1,857,857,0.57143
240,-29,0,0,1,219,248,0.42857
840,0,1,0,1,866,866,0.42857
0,18,0,0,4,25,7,0
0,-14,0,0,4,-21,-7,0
480,-24,0,1,2,454,478,0.71429
480,-76,0,0,2,436,512,0.28571
0,0,1,1,2,19,19,0.71429
480,-37,0,0,1,471,508,0.42857
840,0,1,1,2,829,829,0.71429
480,-48,0,0,1,433,481,0.42857
840,36,0,0,1,839,803,0.42857
840,0,1,1,2,842,842,0.71429
840,-38,0,1,1,803,841,0.57143
480,0,1,0,1,481,481,0.42857
480,2,0,0,1,477,475,0.42857
840,-25,0,1,2,836,861,0.71429
840,0,1,0,1,826,826,0.42857
0,0,1,1,2,-53,-53,0.71429
480,0,1,1,2,487,487,0.71429
480,-11,0,1,4,486,497,1
840,0,1,1,2,834,834,0.71429
240,0,1,1,3,231,231,0.85714
0,0,1,1,3,-35,-35,0.85714
0,0,1,1,2,6,6,0.71429
480,0,1,1,4,486,486,1
840,0,1,1,4,865,865,1
480,0,1,1,3,458,458,0.85714
0,0,1,1,4,6,6,1
480,0,1,1,3,492,492,0.85714
840,-78,0,1,2,832,910,0.71429
240,0,1,1,3,224,224,0.85714
0,-39,0,0,4,6,45,0
240,0,1,1,2,290,290,0.71429
480,0,1,1,2,471,471,0.71429
0,-43,0,0,4,-38,5,0
0,-32,0,0,4,-13,19,0
240,0,1,1,3,236,236,0.85714
480,-5,0,1,3,490,495,0.85714
240,12,0,1,3,235,223,0.85714
240,-17,0,1,2,231,248,0.71429
480,22,0,1,2,507,485,0.71429
840,0,1,1,2,844,844,0.71429
840,2,0,1,2,832,830,0.71429
480,0,1,1,2,507,507,0.71429
0,-23,0,0,4,-19,4,0
840,-17,0,0,1,851,868,0.42857
840,0,1,0,1,859,859,0.42857
480,0,1,1,2,464,464,0.71429
0,-7,0,1,1,8,15,0.57143
480,0,1,1,2,458,458,0.71429
0,0,1,1,2,16,16,0.71429
240,14,0,1,2,262,248,0.71429
0,0,1,1,2,-35,-35,0.71429
480,0,1,1,2,496,496,0.71429
840,0,1,1,1,850,850,0.57143
0,0,1,1,2,6,6,0.71429
0,-46,0,0,4,-41,5,0
840,0,1,1,2,819,819,0.71429
840,10,0,0,1,874,864,0.42857
240,0,1,1,1,268,268,0.57143
840,0,1,1,1,851,851,0.57143
480,-64,0,0,1,427,491,0.42857
240,0,1,1,1,224,224,0.57143
0,-4,0,1,1,1,5,0.57143
0,-23,0,0,4,-48,-25,0
240,18,0,1,1,263,245,0.57143
240,0,1,1,1,252,252,0.57143
0,0,1,1,1,35,35,0.57143
0,0,1,1,1,5,5,0.57143
840,0,1,1,1,810,810,0.57143
480,17,0,1,1,471,454,0.57143
840,-32,0,0,1,810,842,0.42857
240,21,0,0,1,258,237,0.42857
0,-19,0,0,1,-10,9,0.42857
0,0,1,1,1,-5,-5,0.57143
840,0,1,0,1,867,867,0.42857
240,0,1,1,1,224,224,0.57143
0,0,1,1,1,34,34,0.57143
240,0,1,1,1,222,222,0.57143
840,0,1,1,1,807,807,0.57143
480,-1,0,1,1,463,464,0.57143
0,-10,0,0,1,16,26,0.42857
0,-12,0,0,1,16,28,0.42857
0,0,1,1,1,-8,-8,0.57143
840,0,1,1,1,857,857,0.57143
840,27,0,1,1,876,849,0.57143
0,-35,0,0,4,-38,-3,0
840,0,1,1,1,851,851,0.57143
0,-37,0,0,1,-22,15,0.42857
240,-3,0,1,1,223,226,0.57143
0,0,1,0,1,16,16,0.42857
480,0,1,1,1,443,443,0.57143
480,0,1,1,1,459,459,0.57143
0,0,1,0,1,-24,-24,0.42857
0,0,1,0,1,-25,-25,0.42857
240,0,1,1,1,235,235,0.57143
840,0,1,1,1,848,848,0.57143
0,0,1,0,1,-39,-39,0.42857
840,0,1,1,1,847,847,0.57143
840,0,1,1,1,785,785,0.57143
240,-86,0,0,1,203,289,0.42857
840,24,0,0,1,826,802,0.42857
840,0,1,0,1,815,815,0.42857
240,0,1,0,1,244,244,0.42857
0,0,1,1,1,-7,-7,0.57143
240,-4,0,1,1,220,224,0.57143
0,-20,0,0,1,-4,16,0.42857
0,0,1,0,1,3,3,0.42857
480,-13,0,0,1,493,506,0.42857
480,48,0,1,1,515,467,0.57143
240,61,0,0,2,260,199,0.28571
0,0,1,1,1,11,11,0.57143
0,38,0,0,1,17,-21,0.42857
840,-49,0,0,2,827,876,0.28571
240,0,1,1,1,221,221,0.57143
480,0,1,1,1,452,452,0.57143
480,0,1,1,1,514,514,0.57143
840,-48,0,0,1,846,894,0.42857
0,-16,0,1,1,-1,15,0.57143
240,0,1,1,1,262,262,0.57143
240,-3,0,1,1,242,245,0.57143
480,10,0,1,1,474,464,0.57143
480,-6,0,1,1,507,513,0.57143
240,65,0,0,3,268,203,0.14286
840,0,1,1,1,831,831,0.57143
840,0,1,0,1,889,889,0.42857
480,0,1,1,1,491,491,0.57143
480,-8,0,1,1,474,482,0.57143
240,-54,0,0,1,211,265,0.42857
480,107,0,0,4,543,436,0
240,-13,0,1,1,245,258,0.57143
480,-4,0,1,1,483,487,0.57143
0,-5,0,0,1,13,18,0.42857
840,0,1,0,1,818,818,0.42857
480,7,0,1,1,496,489,0.57143
0,0,1,1,1,26,26,0.57143
0,0,1,1,1,7,7,0.57143
240,0,1,1,1,236,236,0.57143
0,34,0,0,1,6,-28,0.42857
480,3,0,1,1,483,480,0.57143
480,0,1,1,1,453,453,0.57143
240,0,1,1,1,258,258,0.57143
240,-2,0,1,1,231,233,0.57143
840,58,0,0,1,849,791,0.42857
0,0,1,0,1,-20,-20,0.42857
840,14,0,1,1,851,837,0.57143
240,13,0,0,1,225,212,0.42857
240,0,1,1,1,238,238,0.57143
0,0,1,1,1,-15,-15,0.57143
840,33,0,0,1,863,830,0.42857
240,0,1,1,1,271,271,0.57143
840,9,0,1,1,825,816,0.57143
840,0,1,1,1,850,850,0.57143
0,0,1,1,1,-18,-18,0.57143
0,-18,0,1,1,9,27,0.57143
480,0,1,1,1,460,460,0.57143
480,0,1,1,1,461,461,0.57143
480,0,1,1,2,481,481,0.71429
0,52,0,0,4,-1,-53,0
0,0,1,1,1,-32,-32,0.57143
840,14,0,1,1,855,841,0.57143
240,-16,0,1,1,237,253,0.57143
840,42,0,1,1,866,824,0.57143
840,15,0,1,2,859,844,0.71429
840,-62,0,1,2,841,903,0.71429
480,0,1,1,1,467,467,0.57143
480,0,1,1,1,475,475,0.57143
840,16,0,1,1,835,819,0.57143
840,0,1,1,1,828,828,0.57143
480,-13,0,1,1,460,473,0.57143
480,0,1,1,1,484,484,0.57143
240,8,0,1,1,261,253,0.57143
480,4,0,1,1,481,477,0.57143
480,0,1,1,1,488,488,0.57143
0,0,1,1,1,11,11,0.57143
240,0,1,1,1,233,233,0.57143
0,-18,0,0,2,-32,-14,0.28571
480,25,0,1,1,470,445,0.57143
240,0,1,0,1,272,272,0.42857
840,0,1,1,1,870,870,0.57143
840,0,1,0,1,799,799,0.42857
0,0,1,1,1,-1,-1,0.57143
840,58,0,1,1,851,793,0.57143
0,-53,0,0,1,-7,46,0.42857
0,0,1,0,1,-19,-19,0.42857
840,-9,0,1,1,834,843,0.57143
480,35,0,0,1,491,456,0.42857
480,0,1,1,1,497,497,0.57143
840,-15,0,1,1,864,879,0.57143
840,-10,0,1,1,839,849,0.57143
480,1,0,1,1,497,496,0.57143
240,0,1,1,1,251,251,0.57143
0,0,1,0,1,30,30,0.42857
0,5,0,1,1,-24,-29,0.57143
240,21,0,1,2,262,241,0.71429
480,30,0,1,1,487,457,0.57143
480,-19,0,1,2,474,493,0.71429
0,-25,0,0,1,-17,8,0.42857
0,32,0,0,1,9,-23,0.42857
0,0,1,1,1,30,30,0.57143
240,-41,0,0,1,226,267,0.42857
480,13,0,1,1,479,466,0.57143
240,-33,0,0,1,220,253,0.42857
240,-54,0,0,1,245,299,0.42857
480,0,1,1,1,465,465,0.57143
0,0,1,0,1,-35,-35,0.42857
840,-33,0,0,1,812,845,0.42857
240,0,1,1,1,237,237,0.57143
840,2,0,0,1,840,838,0.42857
0,0,1,1,1,-37,-37,0.57143
240,0,1,1,1,277,277,0.57143
840,-11,0,1,1,828,839,0.57143
0,102,0,0,1,60,-42,0.42857
840,-49,0,1,1,830,879,0.57143
840,-30,0,0,1,808,838,0.42857
840,-12,0,0,1,842,854,0.42857
240,-47,0,0,1,239,286,0.42857
240,0,1,1,1,248,248,0.57143
480,0,1,0,1,458,458,0.42857
480,23,0,1,1,486,463,0.57143
0,0,1,1,1,17,17,0.57143
240,36,0,0,1,224,188,0.42857
240,-40,0,0,1,198,238,0.42857
480,-13,0,1,1,494,507,0.57143
240,0,1,1,1,243,243,0.57143
240,0,1,1,1,232,232,0.57143
240,0,1,1,1,240,240,0.57143
0,0,1,1,1,20,20,0.57143
840,0,1,1,1,829,829,0.57143
240,-19,0,1,1,232,251,0.57143
240,5,0,1,1,242,237,0.57143
0,22,0,1,1,10,-12,0.57143
0,0,1,1,1,-36,-36,0.57143
480,-30,0,1,1,466,496,0.57143
840,0,1,1,1,829,829,0.57143
480,0,1,1,1,477,477,0.57143
240,0,1,1,1,243,243,0.57143
240,-5,0,1,1,258,263,0.57143
0,0,1,1,1,-20,-20,0.57143
240,0,1,1,1,195,195,0.57143
0,17,0,1,1,31,14,0.57143
0,0,1,1,1,-3,-3,0.57143
480,0,1,1,1,492,492,0.57143
240,-31,0,1,1,223,254,0.57143
480,-9,0,1,1,471,480,0.57143
0,40,0,1,1,45,5,0.57143
840,-38,0,1,1,851,889,0.57143
0,0,1,1,1,9,9,0.57143
240,0,1,1,1,275,275,0.57143
0,40,0,1,1,36,-4,0.57143
0,18,0,0,1,-1,-19,0.42857
240,0,1,1,1,251,251,0.57143
0,-6,0,0,1,-13,-7,0.42857
840,0,1,1,1,836,836,0.57143
840,-37,0,1,1,822,859,0.57143
840,0,1,1,1,793,793,0.57143
240,-41,0,0,1,203,244,0.42857
240,0,1,1,1,244,244,0.57143
0,-8,0,0,1,-17,-9,0.42857
480,0,1,1,1,479,479,0.57143
240,-21,0,1,1,221,242,0.57143
840,-25,0,1,1,831,856,0.57143
240,37,0,1,1,261,224,0.57143
0,0,1,0,1,13,13,0.42857
240,-45,0,0,1,247,292,0.42857
480,-33,0,1,1,474,507,0.57143
480,0,1,1,1,487,487,0.57143
0,0,1,0,1,-20,-20,0.42857
0,0,1,1,1,-33,-33,0.57143
840,0,1,1,1,848,848,0.57143
840,0,1,1,1,849,849,0.57143
480,55,0,1,1,522,467,0.57143
0,0,1,0,1,24,24,0.42857
840,0,1,1,1,853,853,0.57143
240,0,1,1,1,257,257,0.57143
480,0,1,1,1,457,457,0.57143
480,0,1,1,1,486,486,0.57143
240,0,1,1,1,271,271,0.57143
480,0,1,1,1,518,518,0.57143
240,21,0,1,1,255,234,0.57143
240,0,1,1,1,204,204,0.57143
0,-7,0,1,1,-12,-5,0.57143
240,0,1,1,1,211,211,0.57143
480,0,1,1,1,517,517,0.57143
480,-60,0,1,1,457,517,0.57143
840,0,1,1,1,788,788,0.57143
480,0,1,1,1,487,487,0.57143
240,0,1,1,1,215,215,0.57143
840,8,0,0,1,862,854,0.42857
240,0,1,1,1,252,252,0.57143
240,0,1,1,1,253,253,0.57143
240,-70,0,0,1,166,236,0.42857
0,53,0,0,2,-8,-61,0.28571
840,40,0,0,2,845,805,0.28571
840,25,0,0,2,867,842,0.28571
840,-29,0,0,2,855,884,0.28571
840,0,1,0,2,825,825,0.28571
480,0,1,0,1,459,459,0.42857
240,0,1,1,2,221,221,0.71429
840,2,0,0,1,843,841,0.42857
840,0,1,1,1,851,851,0.57143
840,0,1,1,1,839,839,0.57143
240,0,1,1,1,252,252,0.57143
840,0,1,1,1,838,838,0.57143
840,19,0,1,1,875,856,0.57143
480,18,0,0,1,498,480,0.42857
480,14,0,0,1,507,493,0.42857
0,0,1,1,1,-11,-11,0.57143
240,-1,0,1,1,199,200,0.57143
0,0,1,0,1,-25,-25,0.42857
840,-21,0,1,1,842,863,0.57143
480,0,1,1,1,517,517,0.57143
0,-67,0,0,4,-36,31,0
240,-16,0,1,1,231,247,0.57143
480,0,1,1,1,491,491,0.57143
480,0,1,1,1,512,512,0.57143
240,50,0,0,4,264,214,0
480,-12,0,1,2,476,488,0.71429
240,37,0,0,4,249,212,0
240,10,0,1,1,246,236,0.57143
240,22,0,1,1,268,246,0.57143
240,0,1,1,4,216,216,1
240,0,1,1,4,205,205,1
840,0,1,1,1,805,805,0.57143
480,0,1,1,1,479,479,0.57143
840,-55,0,1,1,797,852,0.57143
0,0,1,0,1,-17,-17,0.42857
0,-26,0,0,1,-44,-18,0.42857
480,0,1,1,1,450,450,0.57143
240,0,1,1,1,216,216,0.57143
240,3,0,1,1,226,223,0.57143
480,0,1,1,1,472,472,0.57143
0,0,1,1,1,3,3,0.57143
840,0,1,1,1,817,817,0.57143
480,0,1,1,1,470,470,0.57143
0,-21,0,0,4,-21,0,0
240,-50,0,0,4,217,267,0
840,-16,0,0,1,820,836,0.42857
840,-58,0,0,1,836,894,0.42857
240,10,0,1,1,244,234,0.57143
240,31,0,1,1,248,217,0.57143
240,0,1,1,1,241,241,0.57143
0,0,1,1,1,15,15,0.57143
0,-11,0,0,1,29,40,0.42857
0,-11,0,0,2,-31,-20,0.28571
0,0,1,1,1,0,0,0.57143
480,36,0,1,1,465,429,0.57143
0,0,1,1,1,16,16,0.57143
480,14,0,1,1,492,478,0.57143
840,0,1,1,1,812,812,0.57143
0,12,0,0,1,-8,-20,0.42857
0,44,0,0,1,31,-13,0.42857
840,0,1,1,1,820,820,0.57143
480,0,1,1,1,491,491,0.57143
840,0,1,1,1,827,827,0.57143
0,0,1,1,1,-8,-8,0.57143
240,45,0,0,1,259,214,0.42857
0,9,0,1,1,-17,-26,0.57143
480,0,1,1,1,468,468,0.57143
840,-28,0,1,1,803,831,0.57143
480,0,1,1,1,505,505,0.57143
480,0,1,1,1,494,494,0.57143
0,19,0,0,1,-8,-27,0.42857
240,34,0,1,1,267,233,0.57143
0,10,0,0,1,-23,-33,0.42857
840,59,0,0,1,866,807,0.42857
240,-2,0,1,1,245,247,0.57143
0,0,1,1,1,80,80,0.57143
840,-84,0,1,1,794,878,0.57143
480,0,1,1,1,439,439,0.57143
240,0,1,1,1,250,250,0.57143
480,31,0,1,1,498,467,0.57143
840,27,0,1,1,835,808,0.57143
840,0,1,1,1,855,855,0.57143
0,0,1,1,1,-13,-13,0.57143
240,0,1,1,1,241,241,0.57143
0,0,1,1,1,7,7,0.57143
840,0,1,1,1,838,838,0.57143
480,64,0,1,1,492,428,0.57143
480,26,0,1,1,514,488,0.57143
0,8,0,1,1,-13,-21,0.57143
240,0,1,1,1,229,229,0.57143
480,0,1,1,2,471,471,0.71429
480,38,0,1,2,481,443,0.71429
840,0,1,1,2,816,816,0.71429
480,0,1,1,2,452,452,0.71429
480,0,1,1,1,473,473,0.57143
480,0,1,1,1,498,498,0.57143
840,26,0,1,1,829,803,0.57143
480,0,1,1,1,443,443,0.57143
240,0,1,1,1,205,205,0.57143
840,0,1,1,1,837,837,0.57143
240,0,1,1,1,206,206,0.57143
480,0,1,1,1,428,428,0.57143
840,0,1,1,1,827,827,0.57143
240,0,1,1,1,214,214,0.57143
0,45,0,0,1,16,-29,0.42857
480,-21,0,1,1,484,505,0.57143
240,0,1,1,1,227,227,0.57143
0,6,0,1,1,11,5,0.57143
0,0,1,1,1,-5,-5,0.57143
0,0,1,1,1,32,32,0.57143
840,0,1,1,1,843,843,0.57143
0,0,1,1,1,34,34,0.57143
240,0,1,1,1,233,233,0.57143
480,0,1,1,1,465,465,0.57143
840,24,0,1,1,863,839,0.57143
240,-36,0,0,1,278,314,0.42857
240,0,1,1,1,250,250,0.57143
240,-34,0,1,1,240,274,0.57143
840,0,1,1,1,827,827,0.57143
840,26,0,1,1,864,838,0.57143
480,10,0,1,1,520,510,0.57143
480,0,1,1,1,462,462,0.57143
240,0,1,1,1,248,248,0.57143
240,0,1,1,1,244,244,0.57143
480,-31,0,1,1,472,503,0.57143
840,1,0,1,1,852,851,0.57143
0,-7,0,1,1,-2,5,0.57143
480,0,1,1,1,476,476,0.57143
240,35,0,1,1,269,234,0.57143
480,0,1,1,1,475,475,0.57143
480,0,1,1,1,467,467,0.57143
240,0,1,1,1,230,230,0.57143
840,48,0,0,1,873,825,0.42857
0,0,1,0,1,-11,-11,0.42857
240,-20,0,1,1,246,266,0.57143
840,0,1,1,1,841,841,0.57143
840,47,0,1,1,858,811,0.57143
0,0,1,1,1,-19,-19,0.57143
0,0,1,1,1,35,35,0.57143
240,0,1,1,1,236,236,0.57143
240,0,1,1,1,230,230,0.57143
240,38,0,1,1,251,213,0.57143
840,19,0,1,1,872,853,0.57143
240,-28,0,1,1,231,259,0.57143
240,0,1,1,1,230,230,0.57143
240,0,1,1,1,241,241,0.57143
240,0,1,1,1,269,269,0.57143
840,-63,0,1,1,824,887,0.57143
240,0,1,1,1,238,238,0.57143
240,0,1,1,2,237,237,0.71429
0,0,1,0,1,26,26,0.42857
840,-21,0,0,1,838,859,0.42857
480,0,1,1,1,482,482,0.57143
480,0,1,1,1,522,522,0.57143
840,0,1,1,1,866,866,0.57143
480,-33,0,1,1,423,456,0.57143
480,0,1,1,1,482,482,0.57143
0,-6,0,0,1,-16,-10,0.42857
0,85,0,0,1,41,-44,0.42857
480,-40,0,0,2,470,510,0.28571
0,0,1,1,1,47,47,0.57143
840,11,0,1,1,846,835,0.57143
480,0,1,1,1,508,508,0.57143
840,0,1,1,1,840,840,0.57143
0,11,0,0,1,13,2,0.42857
0,-36,0,0,1,-11,25,0.42857
240,22,0,1,1,261,239,0.57143
0,0,1,0,1,16,16,0.42857
240,0,1,1,1,203,203,0.57143
240,-17,0,0,1,240,257,0.42857
0,0,1,0,1,5,5,0.42857
480,0,1,1,1,458,458,0.57143
840,0,1,1,1,847,847,0.57143
0,0,1,1,1,17,17,0.57143
240,32,0,0,1,241,209,0.42857
0,59,0,0,2,28,-31,0.28571
240,24,0,0,3,242,218,0.14286
840,0,1,1,1,871,871,0.57143
480,0,1,1,1,478,478,0.57143
840,18,0,1,1,853,835,0.57143
0,1,0,1,1,8,7,0.57143
240,0,1,1,1,258,258,0.57143
0,-21,0,0,2,-20,1,0.28571
480,0,1,1,1,506,506,0.57143
240,0,1,1,1,227,227,0.57143
480,-23,0,1,1,475,498,0.57143
840,0,1,1,1,810,810,0.57143
480,-43,0,1,1,476,519,0.57143
480,8,0,1,1,472,464,0.57143
840,-63,0,1,1,834,897,0.57143
840,0,1,1,1,844,844,0.57143
0,34,0,0,2,11,-23,0.28571
0,18,0,0,4,7,-11,0
0,0,1,0,2,-2,-2,0.28571
0,-19,0,0,1,-14,5,0.42857
240,0,1,1,1,238,238,0.57143
240,-16,0,0,1,254,270,0.42857
240,0,1,1,2,275,275,0.71429
840,-22,0,1,2,809,831,0.71429
0,0,1,1,1,19,19,0.57143
840,5,0,1,1,840,835,0.57143
0,-36,0,0,2,-45,-9,0.28571
240,29,0,0,2,266,237,0.28571
480,9,0,1,1,464,455,0.57143
480,50,0,0,1,512,462,0.42857
480,0,1,1,1,454,454,0.57143
0,26,0,0,2,-1,-27,0.28571
480,79,0,0,2,511,432,0.28571
840,28,0,1,2,865,837,0.71429
0,-33,0,0,2,-23,10,0.28571
840,0,1,1,2,848,848,0.71429
240,20,0,1,1,281,261,0.57143
240,0,1,1,1,230,230,0.57143
0,39,0,0,2,17,-22,0.28571
0,0,1,1,1,7,7,0.57143
0,0,1,1,1,12,12,0.57143
240,0,1,1,1,203,203,0.57143
240,0,1,1,1,248,248,0.57143
840,-18,0,1,1,827,845,0.57143
0,0,1,1,1,3,3,0.57143
840,0,1,1,1,829,829,0.57143
240,-5,0,1,1,272,277,0.57143
480,0,1,1,1,519,519,0.57143
240,0,1,1,1,209,209,0.57143
0,-60,0,0,1,-16,44,0.42857
840,0,1,1,1,830,830,0.57143
480,17,0,1,1,486,469,0.57143
0,0,1,1,1,8,8,0.57143
240,-4,0,1,1,225,229,0.57143
480,63,0,1,1,520,457,0.57143
480,-35,0,1,1,469,504,0.57143
240,-17,0,1,1,258,275,0.57143
0,0,1,1,2,16,16,0.71429
240,0,1,1,1,227,227,0.57143
240,0,1,0,1,272,272,0.42857
480,2,0,0,2,480,478,0.28571
480,0,1,1,1,443,443,0.57143
840,-4,0,1,2,837,841,0.71429
840,17,0,0,1,830,813,0.42857
0,0,1,1,1,13,13,0.57143
240,35,0,0,2,251,216,0.28571
0,0,1,1,2,17,17,0.71429
240,-18,0,0,1,229,247,0.42857
480,0,1,1,3,481,481,0.85714
840,0,1,1,3,842,842,0.85714
480,0,1,1,1,468,468,0.57143
0,0,1,1,1,28,28,0.57143
480,0,1,1,1,535,535,0.57143
840,0,1,1,1,788,788,0.57143
240,20,0,0,1,281,261,0.42857
480,0,1,1,1,458,458,0.57143
240,-33,0,0,1,220,253,0.42857
240,0,1,1,1,243,243,0.57143
240,-5,0,1,1,253,258,0.57143
240,0,1,1,1,217,217,0.57143
840,-17,0,0,1,840,857,0.42857
240,-13,0,1,1,220,233,0.57143
0,26,0,0,3,-11,-37,0.14286
840,39,0,0,4,857,818,0
840,31,0,0,1,857,826,0.42857
240,22,0,0,1,267,245,0.42857
0,-48,0,0,3,-47,1,0.14286
240,0,1,0,1,224,224,0.42857
480,0,1,1,1,443,443,0.57143
0,0,1,1,1,4,4,0.57143
0,0,1,1,1,44,44,0.57143
840,6,0,0,1,851,845,0.42857
0,0,1,1,1,18,18,0.57143
0,-13,0,1,1,-4,9,0.57143
840,0,1,0,1,869,869,0.42857
480,0,1,1,1,487,487,0.57143
240,18,0,1,1,265,247,0.57143
480,33,0,0,1,503,470,0.42857
240,0,1,1,1,229,229,0.57143
0,0,1,1,1,-34,-34,0.57143
0,0,1,1,1,-10,-10,0.57143
840,0,1,0,1,819,819,0.42857
840,-30,0,0,1,808,838,0.42857
480,-54,0,0,3,451,505,0.14286
480,0,1,0,1,450,450,0.42857
480,21,0,0,1,498,477,0.42857
240,3,0,1,1,226,223,0.57143
480,0,1,1,1,467,467,0.57143
0,0,1,1,1,20,20,0.57143
0,0,1,1,3,-15,-15,0.85714
480,0,1,0,1,484,484,0.42857
840,-45,0,0,3,847,892,0.14286
240,0,1,1,1,251,251,0.57143
480,1,0,1,1,488,487,0.57143
240,0,1,0,1,233,233,0.42857
240,0,1,1,1,252,252,0.57143
840,14,0,1,1,867,853,0.57143
240,27,0,1,1,235,208,0.57143
240,0,1,1,1,217,217,0.57143
480,59,0,0,3,506,447,0.14286
0,36,0,0,4,-16,-52,0
480,0,1,1,1,469,469,0.57143
0,-22,0,0,1,-31,-9,0.42857
480,0,1,0,2,445,445,0.28571
480,18,0,0,1,533,515,0.42857
480,16,0,1,1,475,459,0.57143
840,12,0,1,1,865,853,0.57143
0,0,1,1,1,-19,-19,0.57143
480,0,1,1,1,480,480,0.57143
0,2,0,1,1,3,1,0.57143
240,21,0,1,1,262,241,0.57143
240,0,1,1,1,238,238,0.57143
240,-17,0,1,1,231,248,0.57143
480,-33,0,1,1,423,456,0.57143
240,-14,0,0,1,219,233,0.42857
0,-36,0,0,1,38,74,0.42857
480,0,1,0,2,476,476,0.28571
840,-60,0,0,1,824,884,0.42857
840,-4,0,0,1,843,847,0.42857
240,0,1,1,1,246,246,0.57143
840,-63,0,0,3,834,897,0.14286
480,37,0,1,1,501,464,0.57143
840,-11,0,0,1,846,857,0.42857
240,0,1,1,1,248,248,0.57143
840,38,0,1,1,857,819,0.57143
840,31,0,1,1,806,775,0.57143
480,-18,0,0,1,489,507,0.42857
480,0,1,1,1,462,462,0.57143
240,0,1,1,1,279,279,0.57143
240,0,1,1,1,236,236,0.57143
480,-18,0,0,1,467,485,0.42857
480,0,1,1,1,483,483,0.57143
0,0,1,1,1,31,31,0.57143
240,0,1,1,1,251,251,0.57143
240,0,1,1,1,250,250,0.57143
0,0,1,1,1,37,37,0.57143
240,0,1,1,1,266,266,0.57143
480,0,1,1,1,498,498,0.57143
240,-38,0,0,1,203,241,0.42857
0,0,1,0,1,-15,-15,0.42857
840,-7,0,0,1,848,855,0.42857
480,6,0,1,1,438,432,0.57143
240,0,1,1,1,231,231,0.57143
840,-5,0,0,1,858,863,0.42857
840,-4,0,0,1,820,824,0.42857
480,0,1,1,1,478,478,0.57143
240,-5,0,1,1,272,277,0.57143
240,42,0,0,1,266,224,0.42857
480,-23,0,1,1,461,484,0.57143
0,10,0,0,1,-23,-33,0.42857
0,14,0,0,1,22,8,0.42857
240,0,1,1,1,214,214,0.57143
240,-76,0,0,4,196,272,0
240,0,1,1,1,236,236,0.57143
240,-36,0,0,1,229,265,0.42857
240,0,1,1,1,220,220,0.57143
240,0,1,1,1,208,208,0.57143
840,37,0,1,1,849,812,0.57143
240,0,1,0,1,233,233,0.42857
480,0,1,1,1,471,471,0.57143
0,0,1,0,1,27,27,0.42857
0,-84,0,0,1,-59,25,0.42857
480,0,1,1,1,456,456,0.57143
240,-49,0,0,3,230,279,0.14286
840,0,1,0,4,852,852,0
0,0,1,0,1,-24,-24,0.42857
480,0,1,1,1,478,478,0.57143
0,-32,0,0,1,-30,2,0.42857
240,0,1,1,1,238,238,0.57143
480,-21,0,1,1,460,481,0.57143
840,-29,0,0,1,819,848,0.42857
240,-43,0,0,1,236,279,0.42857
480,85,0,0,4,521,436,0
0,0,1,0,4,-42,-42,0
240,0,1,1,1,231,231,0.57143
0,0,1,1,1,3,3,0.57143
240,-5,0,1,1,253,258,0.57143
0,43,0,0,4,51,8,0
240,-25,0,1,1,223,248,0.57143
840,4,0,1,1,853,849,0.57143
480,-39,0,0,1,468,507,0.42857
480,0,1,1,1,517,517,0.57143
480,17,0,1,1,480,463,0.57143
480,0,1,1,1,512,512,0.57143
840,0,1,1,1,851,851,0.57143
840,0,1,1,1,809,809,0.57143
840,-37,0,1,1,822,859,0.57143
840,-40,0,1,1,798,838,0.57143
0,0,1,1,1,4,4,0.57143
240,0,1,1,1,222,222,0.57143
480,10,0,1,1,486,476,0.57143
0,-21,0,0,1,2,23,0.42857
480,0,1,1,1,445,445,0.57143
480,0,1,1,1,506,506,0.57143
840,0,1,1,1,815,815,0.57143
240,0,1,1,1,244,244,0.57143
480,-16,0,1,1,477,493,0.57143
0,-9,0,0,1,-6,3,0.42857
840,0,1,1,1,823,823,0.57143
0,0,1,1,1,11,11,0.57143
480,0,1,1,1,462,462,0.57143
240,0,1,1,1,245,245,0.57143
0,0,1,1,1,30,30,0.57143
840,0,1,1,1,829,829,0.57143
0,0,1,1,1,-24,-24,0.57143
0,-50,0,0,3,-22,28,0.14286
240,0,1,1,1,228,228,0.57143
0,9,0,1,1,-17,-26,0.57143
240,0,1,1,1,188,188,0.57143
240,-26,0,1,1,230,256,0.57143
840,21,0,1,1,856,835,0.57143
0,0,1,1,1,-11,-11,0.57143
840,0,1,1,1,875,875,0.57143
480,0,1,1,1,497,497,0.57143
840,-3,0,1,1,842,845,0.57143
0,-37,0,0,3,-9,28,0.14286
240,0,1,1,1,247,247,0.57143
240,-33,0,0,1,212,245,0.42857
840,28,0,1,1,865,837,0.57143
240,19,0,1,1,232,213,0.57143
0,0,1,1,1,-6,-6,0.57143
840,107,0,1,1,903,796,0.57143
480,-40,0,0,1,470,510,0.42857
0,0,1,1,1,2,2,0.57143
840,0,1,1,1,803,803,0.57143
0,0,1,1,1,1,1,0.57143
0,-33,0,0,1,-23,10,0.42857
840,-11,0,0,1,809,820,0.42857
840,0,1,1,1,847,847,0.57143
840,-21,0,0,1,821,842,0.42857
840,0,1,1,1,842,842,0.57143
0,-28,0,0,1,-37,-9,0.42857
240,47,0,0,4,275,228,0
480,0,1,1,1,508,508,0.57143
480,0,1,1,1,477,477,0.57143
0,-25,0,0,3,-21,4,0.14286
0,0,1,1,1,18,18,0.57143
0,0,1,1,1,39,39,0.57143
840,0,1,1,1,816,816,0.57143
840,-11,0,1,1,828,839,0.57143
0,-50,0,0,3,-14,36,0.14286
840,4,0,1,1,841,837,0.57143
480,-64,0,0,3,427,491,0.14286
0,-13,0,1,1,13,26,0.57143
0,-17,0,0,3,18,35,0.14286
480,0,1,1,1,506,506,0.57143
840,45,0,1,1,856,811,0.57143
480,0,1,1,1,480,480,0.57143
0,0,1,1,1,-10,-10,0.57143
480,0,1,1,1,490,490,0.57143
240,61,0,1,1,260,199,0.57143
240,0,1,1,1,229,229,0.57143
840,0,1,1,1,835,835,0.57143
0,36,0,1,1,-15,-51,0.57143
240,0,1,1,1,227,227,0.57143
240,10,0,1,1,279,269,0.57143
840,55,0,0,3,882,827,0.14286
840,0,1,1,1,852,852,0.57143
0,0,1,1,1,-2,-2,0.57143
480,14,0,1,1,491,477,0.57143
240,0,1,1,1,274,274,0.57143
480,8,0,1,1,467,459,0.57143
0,0,1,1,1,-17,-17,0.57143
0,0,1,1,1,30,30,0.57143
240,-28,0,1,1,231,259,0.57143
840,0,1,1,1,858,858,0.57143
480,0,1,1,1,470,470,0.57143
240,11,0,1,1,246,235,0.57143
480,34,0,1,1,491,457,0.57143
480,0,1,1,1,510,510,0.57143
840,-13,0,1,1,854,867,0.57143
840,34,0,0,2,867,833,0.28571
480,0,1,0,2,489,489,0.28571
840,0,1,0,1,852,852,0.42857
240,30,0,1,1,247,217,0.57143
480,0,1,0,1,473,473,0.42857
480,-18,0,1,1,454,472,0.57143
240,-84,0,0,4,194,278,0
240,0,1,0,1,272,272,0.42857
480,36,0,0,1,503,467,0.42857
840,0,1,0,1,866,866,0.42857
480,0,1,0,1,444,444,0.42857
0,0,1,0,1,-33,-33,0.42857
240,0,1,1,1,204,204,0.57143
840,53,0,0,1,832,779,0.42857
840,0,1,0,1,846,846,0.42857
0,0,1,1,1,80,80,0.57143
840,0,1,0,1,829,829,0.42857
240,31,0,1,1,248,217,0.57143
240,0,1,0,1,252,252,0.42857
0,-3,0,0,1,-17,-14,0.42857
240,0,1,1,1,225,225,0.57143
840,-35,0,0,1,829,864,0.42857
480,0,1,1,1,492,492,0.57143
0,0,1,1,1,11,11,0.57143
0,-20,0,0,1,-4,16,0.42857
240,0,1,1,1,251,251,0.57143
840,0,1,0,1,815,815,0.42857
0,23,0,1,1,6,-17,0.57143
0,13,0,0,1,-1,-14,0.42857
0,-54,0,0,4,5,59,0
480,25,0,0,3,507,482,0.14286
0,0,1,0,1,-20,-20,0.42857
840,0,1,0,1,896,896,0.42857
0,-21,0,0,1,-2,19,0.42857
240,14,0,1,1,252,238,0.57143
0,-55,0,0,1,-43,12,0.42857
840,-37,0,0,1,818,855,0.42857
480,0,1,0,1,488,488,0.42857
240,18,0,1,1,239,221,0.57143
840,0,1,0,1,835,835,0.42857
480,-48,0,0,4,486,534,0
0,0,1,1,4,-35,-35,1
480,0,1,1,1,478,478,0.57143
0,27,0,0,4,36,9,0
0,4,0,1,4,11,7,1
240,0,1,1,4,208,208,1
480,0,1,1,3,461,461,0.85714
240,1,0,1,3,252,251,0.85714
0,-43,0,0,4,-38,5,0
840,-13,0,0,1,845,858,0.42857
480,-41,0,0,1,466,507,0.42857
0,0,1,1,1,2,2,0.57143
840,0,1,0,1,833,833,0.42857
480,0,1,0,1,499,499,0.42857
480,-5,0,0,1,489,494,0.42857
480,0,1,0,1,495,495,0.42857
840,-2,0,0,1,867,869,0.42857
840,7,0,0,1,856,849,0.42857
480,-58,0,0,2,476,534,0.28571
0,56,0,0,4,51,-5,0
240,-63,0,0,4,224,287,0
240,0,1,1,4,212,212,1
0,-12,0,0,3,16,28,0.14286
480,0,1,0,1,470,470,0.42857
840,0,1,0,1,855,855,0.42857
480,58,0,1,4,489,431,1
240,-60,0,0,4,217,277,0
240,0,1,1,4,254,254,1
480,52,0,0,4,479,427,0
840,49,0,0,1,855,806,0.42857
240,0,1,1,4,201,201,1
0,0,1,1,4,-1,-1,1
480,-23,0,0,1,432,455,0.42857
240,0,1,1,4,198,198,1
480,0,1,1,4,485,485,1
0,0,1,1,4,-35,-35,1
240,-6,0,1,4,227,233,1
0,0,1,1,4,17,17,1
480,19,0,1,4,515,496,1
840,0,1,1,4,864,864,1
240,-24,0,0,1,214,238,0.42857
480,-12,0,0,1,482,494,0.42857
840,-16,0,0,1,839,855,0.42857
0,0,1,0,1,-22,-22,0.42857
0,0,1,0,1,-11,-11,0.42857
840,34,0,0,1,846,812,0.42857
480,59,0,0,3,508,449,0.14286
0,0,1,1,3,-1,-1,0.85714
240,-17,0,0,1,228,245,0.42857
840,0,1,0,1,850,850,0.42857
0,0,1,1,1,-22,-22,0.57143
0,-10,0,1,3,-1,9,0.85714
240,0,1,1,3,236,236,0.85714
480,-4,0,1,3,465,469,0.85714
480,0,1,1,2,475,475,0.71429
480,-22,0,1,1,499,521,0.57143
840,-16,0,1,1,831,847,0.57143
840,0,1,1,1,847,847,0.57143
0,-34,0,0,3,-0,34,0.14286
240,-19,0,1,1,230,249,0.57143
480,32,0,0,1,481,449,0.42857
480,-2,0,1,1,485,487,0.57143
840,0,1,1,1,827,827,0.57143
0,-39,0,0,1,6,45,0.42857
480,-8,0,1,1,477,485,0.57143
0,0,1,1,1,-9,-9,0.57143
0,0,1,1,1,-10,-10,0.57143
240,0,1,1,1,232,232,0.57143
480,0,1,1,1,464,464,0.57143
240,0,1,1,1,248,248,0.57143
480,0,1,1,1,494,494,0.57143
0,35,0,0,1,29,-6,0.42857
840,0,1,0,1,874,874,0.42857
840,0,1,0,1,823,823,0.42857
840,0,1,0,1,787,787,0.42857
840,0,1,1,1,843,843,0.57143
240,0,1,0,1,224,224,0.42857
840,-38,0,0,1,827,865,0.42857
840,0,1,0,1,846,846,0.42857
480,0,1,1,1,460,460,0.57143
840,0,1,1,1,844,844,0.57143
840,-86,0,0,1,803,889,0.42857
480,0,1,0,1,472,472,0.42857
0,26,0,0,1,37,11,0.42857
0,0,1,0,1,-1,-1,0.42857
480,0,1,0,1,487,487,0.42857
0,0,1,0,1,-13,-13,0.42857
480,-5,0,0,1,490,495,0.42857
840,58,0,0,1,851,793,0.42857
840,-50,0,0,1,806,856,0.42857
240,38,0,1,1,241,203,0.57143
240,-24,0,0,1,200,224,0.42857
240,0,1,1,1,235,235,0.57143
840,0,1,0,1,835,835,0.42857
480,0,1,0,1,467,467,0.42857
480,11,0,0,1,488,477,0.42857
840,0,1,0,1,875,875,0.42857
240,0,1,1,1,275,275,0.57143
480,0,1,1,1,497,497,0.57143
0,8,0,0,1,-1,-9,0.42857
480,26,0,0,1,479,453,0.42857
840,22,0,0,1,850,828,0.42857
240,0,1,0,1,237,237,0.42857
240,-7,0,1,1,228,235,0.57143
840,-12,0,1,1,836,848,0.57143
240,-10,0,1,1,256,266,0.57143
0,0,1,1,1,16,16,0.57143
0,43,0,0,1,22,-21,0.42857
840,0,1,1,1,846,846,0.57143
0,-32,0,0,3,-13,19,0.14286
240,-8,0,1,1,234,242,0.57143
840,44,0,0,1,871,827,0.42857
0,15,0,0,1,11,-4,0.42857
480,0,1,0,1,506,506,0.42857
0,-11,0,0,1,29,40,0.42857
240,29,0,0,1,265,236,0.42857
480,11,0,1,1,491,480,0.57143
840,102,0,0,1,900,798,0.42857
0,0,1,0,1,35,35,0.42857
240,0,1,1,1,249,249,0.57143
0,0,1,1,1,0,0,0.57143
480,-33,0,1,1,474,507,0.57143
240,0,1,1,1,243,243,0.57143
480,-31,0,0,1,463,494,0.42857
240,0,1,1,1,176,176,0.57143
0,25,0,0,1,-10,-35,0.42857
480,10,0,0,1,477,467,0.42857
240,-46,0,0,1,199,245,0.42857
0,0,1,1,1,-10,-10,0.57143
480,0,1,1,1,488,488,0.57143
240,0,1,1,1,248,248,0.57143
840,0,1,0,1,825,825,0.42857
480,0,1,1,1,450,450,0.57143
480,-38,0,0,1,491,529,0.42857
840,-6,0,1,1,824,830,0.57143
840,0,1,1,1,793,793,0.57143
480,-30,0,1,1,466,496,0.57143
0,-29,0,0,1,15,44,0.42857
240,18,0,1,1,263,245,0.57143
0,40,0,0,1,36,-4,0.42857
480,0,1,1,1,452,452,0.57143
840,76,0,0,1,874,798,0.42857
840,0,1,1,1,838,838,0.57143
0,-25,0,0,1,-4,21,0.42857
840,-8,0,1,1,823,831,0.57143
0,0,1,1,1,-19,-19,0.57143
840,36,0,0,1,862,826,0.42857
0,6,0,1,1,-10,-16,0.57143
480,10,0,1,1,520,510,0.57143
840,0,1,1,1,871,871,0.57143
240,5,0,1,1,242,237,0.57143
840,-21,0,0,1,819,840,0.42857
0,19,0,1,1,16,-3,0.57143
0,0,1,1,1,-25,-25,0.57143
240,38,0,1,1,260,222,0.57143
840,0,1,1,1,870,870,0.57143
840,0,1,1,1,827,827,0.57143
840,0,1,1,1,839,839,0.57143
0,0,1,1,1,-37,-37,0.57143
840,19,0,1,1,872,853,0.57143
480,45,0,0,1,499,454,0.42857
840,-1,0,1,1,799,800,0.57143
840,0,1,1,1,889,889,0.57143
0,17,0,1,1,6,-11,0.57143
840,18,0,0,1,853,835,0.42857
840,47,0,1,1,858,811,0.57143
480,8,0,1,1,472,464,0.57143
480,-20,0,1,1,486,506,0.57143
480,0,1,1,1,435,435,0.57143
240,26,0,1,1,274,248,0.57143
240,0,1,1,1,283,283,0.57143
480,-6,0,1,1,507,513,0.57143
240,0,1,1,1,215,215,0.57143
0,9,0,1,1,35,26,0.57143
840,0,1,0,1,777,777,0.42857
480,0,1,1,1,500,500,0.57143
480,0,1,1,1,496,496,0.57143
0,0,1,1,1,-20,-20,0.57143
840,36,0,1,1,839,803,0.57143
0,46,0,0,1,40,-6,0.42857
0,0,1,1,1,-22,-22,0.57143
480,8,0,1,1,501,493,0.57143
840,0,1,1,1,851,851,0.57143
480,0,1,1,1,462,462,0.57143
240,38,0,0,1,251,213,0.42857
0,0,1,1,1,-33,-33,0.57143
240,55,0,0,1,275,220,0.42857
840,0,1,1,1,810,810,0.57143
240,0,1,1,1,212,212,0.57143
840,18,0,0,1,847,829,0.42857
0,0,1,1,1,7,7,0.57143
240,50,0,0,1,272,222,0.42857
240,0,1,1,1,251,251,0.57143
480,0,1,1,1,488,488,0.57143
240,0,1,1,1,218,218,0.57143
480,0,1,0,1,517,517,0.42857
0,0,1,1,1,-4,-4,0.57143
840,0,1,1,1,821,821,0.57143
480,0,1,1,1,493,493,0.57143
0,48,0,0,1,35,-13,0.42857
240,0,1,1,1,227,227,0.57143
0,32,0,0,1,9,-23,0.42857
0,0,1,1,1,24,24,0.57143
840,0,1,0,1,820,820,0.42857
240,64,0,0,1,252,188,0.42857
480,0,1,0,1,483,483,0.42857
0,0,1,1,1,11,11,0.57143
840,0,1,0,1,856,856,0.42857
0,-7,0,1,1,-8,-1,0.57143
0,9,0,0,1,-16,-25,0.42857
840,-1,0,0,1,823,824,0.42857
480,-51,0,0,1,436,487,0.42857
240,0,1,0,1,221,221,0.42857
240,0,1,1,1,277,277,0.57143
840,21,0,0,1,855,834,0.42857
0,0,1,1,1,-47,-47,0.57143
840,9,0,0,1,825,816,0.42857
240,0,1,1,1,204,204,0.57143
840,0,1,0,1,857,857,0.42857
480,0,1,1,1,454,454,0.57143
480,0,1,1,1,452,452,0.57143
480,0,1,1,1,468,468,0.57143
840,24,0,0,1,863,839,0.42857
0,0,1,1,1,4,4,0.57143
0,-14,0,0,1,-9,5,0.42857
240,-44,0,0,1,203,247,0.42857
0,17,0,0,3,-9,-26,0.14286
0,0,1,1,1,-16,-16,0.57143
480,0,1,1,1,466,466,0.57143
840,0,1,0,1,846,846,0.42857
0,63,0,0,4,40,-23,0
840,0,1,0,1,826,826,0.42857
240,-53,0,0,1,233,286,0.42857
240,0,1,1,1,232,232,0.57143
240,16,0,1,1,236,220,0.57143
240,0,1,1,1,218,218,0.57143
240,0,1,1,1,193,193,0.57143
240,0,1,1,1,209,209,0.57143
480,10,0,1,1,484,474,0.57143
0,10,0,1,1,-6,-16,0.57143
480,-35,0,0,1,442,477,0.42857
840,0,1,1,1,838,838,0.57143
480,0,1,1,1,463,463,0.57143
480,0,1,1,1,497,497,0.57143
480,-70,0,0,1,406,476,0.42857
240,0,1,1,1,211,211,0.57143
840,0,1,0,1,851,851,0.42857
480,-18,0,1,1,448,466,0.57143
0,0,1,0,1,-11,-11,0.42857
840,0,1,1,1,852,852,0.57143
840,0,1,1,1,785,785,0.57143
480,0,1,1,1,488,488,0.57143
240,-23,0,0,1,235,258,0.42857
0,0,1,0,1,-38,-38,0.42857
240,0,1,1,1,278,278,0.57143
480,0,1,0,1,449,449,0.42857
0,0,1,1,1,-7,-7,0.57143
480,65,0,0,1,508,443,0.42857
840,-25,0,0,1,831,856,0.42857
0,17,0,1,1,31,14,0.57143
240,0,1,0,1,262,262,0.42857
840,0,1,0,1,862,862,0.42857
240,-4,0,1,1,241,245,0.57143
840,0,1,0,1,851,851,0.42857
0,-67,0,0,4,-36,31,0
480,0,1,1,1,453,453,0.57143
480,0,1,1,1,474,474,0.57143
840,-15,0,0,1,819,834,0.42857
840,0,1,1,1,830,830,0.57143
480,0,1,1,1,445,445,0.57143
240,13,0,1,1,225,212,0.57143
480,24,0,1,1,466,442,0.57143
840,15,0,1,1,859,844,0.57143
240,0,1,1,1,205,205,0.57143
240,0,1,1,2,230,230,0.71429
840,18,0,1,2,858,840,0.71429
240,2,0,1,2,237,235,0.71429
0,0,1,1,2,1,1,0.71429
0,0,1,1,2,12,12,0.71429
840,0,1,1,2,882,882,0.71429
0,-19,0,1,2,-8,11,0.71429
840,0,1,1,1,848,848,0.57143
240,-52,0,0,4,214,266,0
0,12,0,0,4,-5,-17,0
840,0,1,1,1,849,849,0.57143
480,-36,0,0,1,435,471,0.42857
240,0,1,1,1,258,258,0.57143
240,48,0,0,4,273,225,0
840,-16,0,0,4,820,836,0
0,-7,0,0,1,23,30,0.42857
0,22,0,0,4,28,6,0
240,0,1,0,2,199,199,0.28571
0,-50,0,0,2,-23,27,0.28571
840,0,1,0,1,832,832,0.42857
0,0,1,1,1,-23,-23,0.57143
0,13,0,0,2,12,-1,0.28571
0,0,1,1,1,-28,-28,0.57143
240,-19,0,1,4,234,253,1
840,-19,0,1,4,826,845,1
0,24,0,0,3,2,-22,0.14286
480,71,0,0,3,499,428,0.14286
480,0,1,0,3,508,508,0.14286
0,79,0,0,4,31,-48,0
240,30,0,0,3,259,229,0.14286
840,14,0,0,2,855,841,0.28571
840,-9,0,0,2,831,840,0.28571
480,0,1,1,3,487,487,0.85714
840,23,0,0,3,851,828,0.14286
480,1,0,1,2,470,469,0.71429
0,0,1,1,3,32,32,0.85714
840,-69,0,0,3,829,898,0.14286
840,0,1,0,3,819,819,0.14286
0,0,1,1,4,27,27,1
840,-10,0,1,4,840,850,1
240,0,1,1,4,247,247,1
240,0,1,1,4,256,256,1
240,0,1,1,4,246,246,1
480,-78,0,0,3,472,550,0.14286
840,0,1,0,2,856,856,0.28571
480,2,0,1,4,472,470,1
480,0,1,1,4,522,522,1
240,12,0,1,4,232,220,1
240,-49,0,1,4,227,276,1
240,-41,0,1,4,203,244,1
240,0,1,1,2,244,244,0.71429
0,0,1,0,4,-16,-16,0
840,-19,0,0,1,825,844,0.42857
480,19,0,1,1,489,470,0.57143
480,11,0,0,1,484,473,0.42857
240,-11,0,0,1,230,241,0.42857
840,0,1,1,1,833,833,0.57143
480,0,1,0,1,485,485,0.42857
480,0,1,1,1,511,511,0.57143
480,-2,0,0,1,485,487,0.42857
480,0,1,1,1,445,445,0.57143
0,-17,0,0,1,2,19,0.42857
840,6,0,0,1,830,824,0.42857
840,-11,0,0,1,836,847,0.42857
480,4,0,1,1,499,495,0.57143
480,0,1,1,1,494,494,0.57143
0,10,0,1,3,1,-9,0.85714
240,0,1,1,3,243,243,0.85714
480,-30,0,0,1,439,469,0.42857
0,0,1,0,1,8,8,0.42857
840,29,0,1,3,876,847,0.85714
840,-10,0,0,1,834,844,0.42857
480,29,0,1,3,480,451,0.85714
240,38,0,1,3,283,245,0.85714
0,-11,0,0,2,-21,-10,0.28571
840,-5,0,1,1,832,837,0.57143
240,0,1,1,3,269,269,0.85714
240,-30,0,1,3,188,218,0.85714
480,11,0,1,3,470,459,0.85714
240,0,1,1,3,234,234,0.85714
480,-23,0,1,3,497,520,0.85714
840,0,1,0,1,866,866,0.42857
480,0,1,1,2,468,468,0.71429
0,2,0,0,1,10,8,0.42857
840,0,1,1,2,833,833,0.71429
0,0,1,1,2,20,20,0.71429
240,15,0,1,3,230,215,0.85714
240,8,0,1,3,201,193,0.85714
240,-3,0,1,3,253,256,0.85714
0,0,1,1,3,-18,-18,0.85714
240,0,1,1,3,246,246,0.85714
840,0,1,0,1,858,858,0.42857
0,0,1,1,3,-39,-39,0.85714
480,-57,0,1,3,433,490,0.85714
240,-7,0,1,3,259,266,0.85714
840,0,1,1,3,829,829,0.85714
240,22,0,1,1,242,220,0.57143
480,11,0,1,3,454,443,0.85714
480,-50,0,0,1,472,522,0.42857
480,0,1,1,3,466,466,0.85714
0,30,0,0,1,9,-21,0.42857
840,-6,0,0,1,857,863,0.42857
0,0,1,1,3,-4,-4,0.85714
240,10,0,1,3,239,229,0.85714
840,0,1,1,3,819,819,0.85714
840,43,0,1,2,865,822,0.71429
840,0,1,1,2,859,859,0.71429
480,38,0,1,1,499,461,0.57143
840,0,1,1,1,828,828,0.57143
240,0,1,1,1,244,244,0.57143
840,0,1,1,1,883,883,0.57143
840,0,1,1,1,827,827,0.57143
480,8,0,1,1,501,493,0.57143
240,0,1,1,1,269,269,0.57143
840,17,0,0,1,864,847,0.42857
0,0,1,0,1,13,13,0.42857
840,0,1,0,1,845,845,0.42857
480,-4,0,1,1,493,497,0.57143
480,0,1,1,1,493,493,0.57143
0,-4,0,0,1,-10,-6,0.42857
240,0,1,1,1,247,247,0.57143
0,-14,0,0,1,-3,11,0.42857
240,-9,0,1,1,218,227,0.57143
840,0,1,0,1,867,867,0.42857
840,0,1,1,1,843,843,0.57143
840,0,1,1,1,833,833,0.57143
240,47,0,0,1,245,198,0.42857
480,0,1,1,1,455,455,0.57143
0,-25,0,0,1,13,38,0.42857
0,0,1,1,1,-20,-20,0.57143
480,-21,0,1,1,473,494,0.57143
480,0,1,1,1,495,495,0.57143
480,59,0,0,1,546,487,0.42857
240,0,1,1,1,225,225,0.57143
480,-37,0,1,1,452,489,0.57143
480,0,1,1,1,470,470,0.57143
0,-32,0,0,1,-38,-6,0.42857
480,0,1,1,1,492,492,0.57143
240,-20,0,0,1,277,297,0.42857
240,0,1,1,1,268,268,0.57143
0,0,1,1,1,16,16,0.57143
240,-55,0,0,1,231,286,0.42857
840,0,1,1,1,835,835,0.57143
840,-35,0,1,1,812,847,0.57143
840,0,1,1,1,847,847,0.57143
240,0,1,1,1,226,226,0.57143
240,-25,0,1,1,212,237,0.57143
840,3,0,0,1,808,805,0.42857
240,0,1,1,1,217,217,0.57143
840,0,1,1,1,834,834,0.57143
240,14,0,1,1,224,210,0.57143
240,9,0,1,1,253,244,0.57143
0,14,0,1,1,3,-11,0.57143
480,0,1,1,1,461,461,0.57143
240,0,1,1,1,266,266,0.57143
840,0,1,1,1,811,811,0.57143
480,0,1,1,1,496,496,0.57143
0,21,0,0,1,-2,-23,0.42857
840,0,1,1,1,805,805,0.57143
480,0,1,1,1,461,461,0.57143
0,0,1,1,1,14,14,0.57143
0,39,0,0,1,0,-39,0.42857
480,0,1,0,1,514,514,0.42857
0,30,0,0,1,-14,-44,0.42857
0,50,0,1,1,10,-40,0.57143
0,0,1,1,1,34,34,0.57143
240,0,1,0,1,228,228,0.42857
840,50,0,1,1,866,816,0.57143
840,16,0,0,1,861,845,0.42857
240,87,0,0,4,287,200,0
0,0,1,0,4,-19,-19,0
0,30,0,1,4,46,16,1
480,5,0,1,1,487,482,0.57143
840,0,1,1,4,843,843,1
0,27,0,1,4,-9,-36,1
0,17,0,1,4,-4,-21,1
240,0,1,0,4,249,249,0
480,0,1,0,4,532,532,0
0,0,1,0,1,16,16,0.42857
0,0,1,0,4,8,8,0
480,12,0,0,4,470,458,0
480,0,1,1,2,491,491,0.71429
480,0,1,0,1,470,470,0.42857
480,-10,0,0,1,446,456,0.42857
840,-8,0,0,1,828,836,0.42857
0,-14,0,0,1,25,39,0.42857
0,16,0,1,1,-5,-21,0.57143
840,22,0,0,1,873,851,0.42857
480,33,0,0,1,481,448,0.42857
240,-12,0,0,1,250,262,0.42857
240,0,1,0,1,243,243,0.42857
0,0,1,0,1,0,0,0.42857
480,0,1,0,1,476,476,0.42857
240,0,1,0,1,214,214,0.42857
0,0,1,0,1,5,5,0.42857
840,0,1,1,1,818,818,0.57143
0,-67,0,0,1,-21,46,0.42857
480,-18,0,0,1,456,474,0.42857
240,0,1,0,1,241,241,0.42857
240,0,1,0,1,241,241,0.42857
480,71,0,1,1,473,402,0.57143
840,0,1,0,1,828,828,0.42857
480,-22,0,0,1,477,499,0.42857
0,-33,0,0,1,-23,10,0.42857
480,0,1,0,1,490,490,0.42857
0,-8,0,0,1,1,9,0.42857
480,16,0,0,1,509,493,0.42857
840,-7,0,0,1,806,813,0.42857
480,20,0,0,1,485,465,0.42857
840,4,0,0,1,926,922,0.42857
480,0,1,0,1,471,471,0.42857
240,0,1,0,1,260,260,0.42857
480,-39,0,0,1,427,466,0.42857
0,0,1,0,1,12,12,0.42857
840,-25,0,0,1,826,851,0.42857
840,0,1,0,1,798,798,0.42857
240,0,1,0,1,260,260,0.42857
240,0,1,0,1,283,283,0.42857
0,18,0,0,1,-19,-37,0.42857
480,0,1,0,1,484,484,0.42857
0,0,1,0,1,10,10,0.42857
840,0,1,0,1,828,828,0.42857
840,0,1,0,1,851,851,0.42857
240,0,1,0,1,311,311,0.42857
240,-50,0,0,1,217,267,0.42857
0,0,1,1,1,-11,-11,0.57143
480,-20,0,0,1,455,475,0.42857
480,17,0,1,1,490,473,0.57143
0,22,0,0,1,15,-7,0.42857
480,0,1,0,1,493,493,0.42857
840,0,1,0,1,837,837,0.42857
840,0,1,0,1,821,821,0.42857
840,0,1,0,1,832,832,0.42857
0,-7,0,0,1,0,7,0.42857
840,0,1,0,1,806,806,0.42857
240,-45,0,0,1,226,271,0.42857
840,0,1,0,1,807,807,0.42857
840,-38,0,0,1,831,869,0.42857
480,-47,0,0,1,465,512,0.42857
0,0,1,0,1,0,0,0.42857
0,0,1,0,1,4,4,0.42857
240,0,1,0,1,230,230,0.42857
240,-68,0,0,1,178,246,0.42857
840,22,0,0,1,855,833,0.42857
0,0,1,0,1,-7,-7,0.42857
480,0,1,0,1,482,482,0.42857
840,0,1,0,1,805,805,0.42857
480,35,0,0,1,513,478,0.42857
480,0,1,0,1,466,466,0.42857
0,0,1,0,1,33,33,0.42857
840,16,0,0,1,834,818,0.42857
0,36,0,0,1,13,-23,0.42857
840,0,1,0,1,822,822,0.42857
0,0,1,0,1,-4,-4,0.42857
840,0,1,0,1,846,846,0.42857
0,0,1,0,1,21,21,0.42857
0,-31,0,0,1,15,46,0.42857
840,-51,0,0,1,816,867,0.42857
480,0,1,0,1,515,515,0.42857
480,26,0,1,1,486,460,0.57143
240,-18,0,0,1,223,241,0.42857
480,0,1,0,1,492,492,0.42857
0,1,0,1,1,29,28,0.57143
840,0,1,0,1,835,835,0.42857
240,19,0,0,1,261,242,0.42857
480,0,1,0,1,475,475,0.42857
840,30,0,1,1,865,835,0.57143
840,-23,0,0,1,839,862,0.42857
0,-10,0,0,1,-19,-9,0.42857
0,-89,0,0,1,-49,40,0.42857
0,-7,0,1,1,-20,-13,0.57143
840,-51,0,0,1,782,833,0.42857
840,0,1,1,1,850,850,0.57143
480,0,1,0,1,482,482,0.42857
240,32,0,0,1,261,229,0.42857
480,0,1,1,1,452,452,0.57143
0,0,1,1,1,-11,-11,0.57143
240,10,0,1,1,233,223,0.57143
480,0,1,0,1,514,514,0.42857
480,0,1,1,1,468,468,0.57143
0,-34,0,0,1,4,38,0.42857
840,3,0,1,1,865,862,0.57143
0,0,1,1,1,-31,-31,0.57143
840,28,0,1,1,845,817,0.57143
0,0,1,1,1,-35,-35,0.57143
240,0,1,1,3,229,229,0.85714
240,-17,0,1,1,246,263,0.57143
840,0,1,0,3,859,859,0.14286
240,0,1,1,3,224,224,0.85714
480,0,1,1,4,494,494,1
840,1,0,1,3,823,822,0.85714
0,41,0,0,4,13,-28,0
240,-68,0,0,4,223,291,0
0,0,1,1,3,-27,-27,0.85714
0,0,1,1,4,22,22,1
840,19,0,0,1,884,865,0.42857
840,19,0,1,3,891,872,0.85714
0,0,1,0,1,9,9,0.42857
240,-31,0,0,1,217,248,0.42857
480,64,0,0,1,500,436,0.42857
480,0,1,0,1,477,477,0.42857
240,26,0,0,1,260,234,0.42857
240,-27,0,1,2,235,262,0.71429
840,-27,0,1,2,838,865,0.71429
480,22,0,0,1,452,430,0.42857
0,-24,0,0,4,-46,-22,0
0,0,1,1,4,-30,-30,1
480,37,0,0,1,497,460,0.42857
840,0,1,1,1,844,844,0.57143
240,-7,0,1,1,214,221,0.57143
480,-13,0,1,3,473,486,0.85714
240,42,0,0,3,274,232,0.14286
840,0,1,0,1,852,852,0.42857
240,0,1,1,4,242,242,1
480,11,0,0,1,546,535,0.42857
480,0,1,0,1,516,516,0.42857
0,-2,0,1,4,-12,-10,1
0,0,1,1,4,8,8,1
840,0,1,0,1,872,872,0.42857
0,24,0,0,4,42,18,0
0,0,1,1,4,-8,-8,1
840,0,1,1,4,856,856,1
480,-63,0,0,3,457,520,0.14286
480,0,1,0,3,455,455,0.14286
240,-4,0,1,3,241,245,0.85714
240,64,0,0,3,251,187,0.14286
240,-66,0,0,3,205,271,0.14286
240,0,1,1,3,248,248,0.85714
480,0,1,1,3,467,467,0.85714
480,0,1,1,3,490,490,0.85714
240,0,1,1,3,270,270,0.85714
840,26,0,0,1,852,826,0.42857
240,0,1,1,3,221,221,0.85714
840,0,1,0,1,811,811,0.42857
480,22,0,1,3,490,468,0.85714
240,10,0,1,3,252,242,0.85714
840,-5,0,0,3,888,893,0.14286
480,12,0,1,3,465,453,0.85714
0,13,0,1,3,19,6,0.85714
840,33,0,1,3,839,806,0.85714
480,0,1,1,3,504,504,0.85714
840,-1,0,1,3,839,840,0.85714
480,-19,0,1,3,438,457,0.85714
0,-42,0,0,3,-30,12,0.14286
240,0,1,1,3,223,223,0.85714
840,-12,0,1,3,844,856,0.85714
240,16,0,1,3,244,228,0.85714
240,0,1,1,3,259,259,0.85714
240,0,1,1,3,251,251,0.85714
240,0,1,1,3,231,231,0.85714
840,0,1,0,1,814,814,0.42857
840,16,0,1,1,801,785,0.57143
480,-2,0,1,1,473,475,0.57143
480,-7,0,1,1,454,461,0.57143
240,0,1,1,1,217,217,0.57143
840,0,1,1,1,838,838,0.57143
240,-8,0,1,1,247,255,0.57143
480,0,1,1,1,511,511,0.57143
0,0,1,1,1,7,7,0.57143
0,0,1,1,1,-10,-10,0.57143
480,0,1,1,1,521,521,0.57143
240,53,0,0,3,274,221,0.14286
840,0,1,1,1,836,836,0.57143
480,0,1,0,1,479,479,0.42857
240,0,1,0,1,263,263,0.42857
0,10,0,0,1,19,9,0.42857
480,0,1,0,1,499,499,0.42857
480,-41,0,0,1,452,493,0.42857
0,0,1,0,1,30,30,0.42857
240,0,1,1,1,230,230,0.57143
0,0,1,1,3,-36,-36,0.85714
480,-84,0,0,3,433,517,0.14286
840,0,1,0,1,819,819,0.42857
480,45,0,0,1,481,436,0.42857
480,-37,0,0,1,437,474,0.42857
480,0,1,1,1,499,499,0.57143
840,0,1,0,1,831,831,0.42857
840,0,1,1,1,814,814,0.57143
240,-53,0,0,1,216,269,0.42857
480,0,1,0,1,482,482,0.42857
480,0,1,1,1,472,472,0.57143
480,6,0,1,2,498,492,0.71429
840,28,0,0,1,853,825,0.42857
480,-27,0,0,1,466,493,0.42857
0,0,1,1,1,14,14,0.57143
240,-20,0,1,1,247,267,0.57143
240,-7,0,1,1,233,240,0.57143
480,1,0,1,1,490,489,0.57143
240,0,1,1,1,253,253,0.57143
0,14,0,0,1,28,14,0.42857
240,0,1,1,1,239,239,0.57143
0,0,1,0,1,63,63,0.42857
240,0,1,0,1,306,306,0.42857
240,0,1,1,1,232,232,0.57143
480,0,1,1,1,488,488,0.57143
840,0,1,0,1,849,849,0.42857
0,0,1,1,1,3,3,0.57143
240,0,1,1,3,222,222,0.85714
480,0,1,1,3,466,466,0.85714
480,56,0,0,3,512,456,0.14286
840,-18,0,0,1,808,826,0.42857
240,0,1,1,3,208,208,0.85714
480,0,1,1,4,480,480,1
480,0,1,1,4,481,481,1
0,0,1,1,4,-31,-31,1
0,0,1,1,4,39,39,1
0,-10,0,0,1,29,39,0.42857
0,0,1,1,4,-34,-34,1
240,0,1,1,4,255,255,1
240,-6,0,1,4,223,229,1
480,0,1,1,4,484,484,1
480,0,1,1,4,516,516,1
0,22,0,0,1,4,-18,0.42857
840,55,0,1,1,887,832,0.57143
240,9,0,1,1,235,226,0.57143
0,-37,0,0,1,-21,16,0.42857
240,0,1,0,1,231,231,0.42857
480,-11,0,0,1,450,461,0.42857
480,0,1,0,1,458,458,0.42857
240,0,1,1,1,242,242,0.57143
240,0,1,1,1,202,202,0.57143
240,0,1,1,3,246,246,0.85714
240,-4,0,1,2,261,265,0.71429
0,0,1,1,3,12,12,0.85714
480,0,1,1,1,480,480,0.57143
840,0,1,1,1,874,874,0.57143
0,0,1,1,1,3,3,0.57143
0,-26,0,0,1,-18,8,0.42857
480,-44,0,1,1,452,496,0.57143
840,20,0,1,1,882,862,0.57143
840,0,1,1,1,835,835,0.57143
840,0,1,1,1,843,843,0.57143
840,-11,0,1,1,832,843,0.57143
480,36,0,1,1,525,489,0.57143
480,-67,0,0,1,447,514,0.42857
240,0,1,1,1,267,267,0.57143
240,0,1,1,1,260,260,0.57143
840,0,1,1,1,840,840,0.57143
0,0,1,1,1,-17,-17,0.57143
0,0,1,1,1,-6,-6,0.57143
840,0,1,1,1,851,851,0.57143
240,22,0,1,1,250,228,0.57143
840,17,0,1,1,865,848,0.57143
240,-5,0,1,1,228,233,0.57143
0,16,0,1,1,-23,-39,0.57143
840,0,1,1,1,882,882,0.57143
480,48,0,1,1,497,449,0.57143
0,0,1,1,1,16,16,0.57143
840,0,1,1,2,854,854,0.71429
0,0,1,1,2,-19,-19,0.71429
480,0,1,1,2,441,441,0.71429
240,0,1,1,2,184,184,0.71429
0,0,1,1,2,57,57,0.71429
840,0,1,1,2,803,803,0.71429
0,3,0,1,2,-4,-7,0.71429
240,-17,0,1,2,191,208,0.71429
0,-25,0,0,3,-21,4,0.14286
0,36,0,1,3,17,-19,0.85714
0,-15,0,0,3,-24,-9,0.14286
0,-11,0,0,3,-30,-19,0.14286
240,9,0,1,2,222,213,0.71429
240,0,1,0,1,290,290,0.42857
480,14,0,1,1,529,515,0.57143
0,-37,0,0,2,-14,23,0.28571
240,23,0,0,1,242,219,0.42857
0,22,0,0,3,-9,-31,0.14286
240,0,1,1,1,232,232,0.57143
480,2,0,1,1,470,468,0.57143
840,0,1,1,1,832,832,0.57143
0,0,1,1,1,-16,-16,0.57143
240,0,1,1,1,236,236,0.57143
480,69,0,1,1,537,468,0.57143
240,0,1,1,1,231,231,0.57143
480,0,1,1,1,502,502,0.57143
840,35,0,1,1,834,799,0.57143
840,12,0,1,1,873,861,0.57143
240,4,0,1,1,238,234,0.57143
0,14,0,0,1,48,34,0.42857
840,18,0,1,1,851,833,0.57143
240,0,1,1,1,214,214,0.57143
0,0,1,1,1,55,55,0.57143
240,56,0,0,3,244,188,0.14286
240,0,1,1,1,278,278,0.57143
0,17,0,1,1,15,-2,0.57143
240,-30,0,1,1,239,269,0.57143
480,0,1,1,1,479,479,0.57143
840,51,0,0,1,884,833,0.42857
240,-9,0,1,1,224,233,0.57143
0,-3,0,0,1,-14,-11,0.42857
480,1,0,1,1,475,474,0.57143
0,0,1,0,1,-23,-23,0.42857
240,0,1,0,1,225,225,0.42857
840,21,0,1,2,863,842,0.71429
840,-21,0,1,2,845,866,0.71429
480,0,1,1,2,456,456,0.71429
0,68,0,0,3,20,-48,0.14286
240,-14,0,1,4,223,237,1
240,0,1,1,2,251,251,0.71429
840,0,1,0,1,817,817,0.42857
480,-1,0,0,1,511,512,0.42857
840,-10,0,0,1,840,850,0.42857
240,13,0,0,2,219,206,0.28571
0,0,1,1,3,12,12,0.85714
840,0,1,1,3,841,841,0.85714
0,0,1,1,3,-44,-44,0.85714
240,52,0,0,4,259,207,0
0,0,1,0,4,-13,-13,0
840,-5,0,1,4,830,835,1
0,51,0,0,4,28,-23,0
0,0,1,1,4,-26,-26,1
840,18,0,1,4,862,844,1
480,9,0,1,4,484,475,1
0,47,0,0,4,48,1,0
480,9,0,1,3,478,469,0.85714
240,-15,0,1,4,218,233,1
480,0,1,1,4,458,458,1
0,15,0,0,4,13,-2,0
840,39,0,0,4,840,801,0
0,17,0,1,4,-29,-46,1
0,-14,0,0,4,1,15,0
0,0,1,1,4,64,64,1
0,0,1,1,4,-14,-14,1
240,0,1,1,4,259,259,1
480,0,1,1,4,490,490,1
840,0,1,1,4,869,869,1
0,-10,0,0,4,1,11,0
840,-2,0,1,1,853,855,0.57143
840,-57,0,1,3,815,872,0.85714
0,2,0,0,3,12,10,0.14286
0,-22,0,0,1,-16,6,0.42857
240,-12,0,1,4,238,250,1
240,-5,0,1,4,226,231,1
480,0,1,1,4,457,457,1
480,3,0,1,4,468,465,1
240,0,1,1,4,252,252,1
480,0,1,1,4,451,451,1
480,-32,0,1,4,479,511,1
240,14,0,1,4,239,225,1
480,0,1,1,4,485,485,1
240,0,1,1,4,226,226,1
840,7,0,1,4,818,811,1
240,35,0,1,4,291,256,1
0,0,1,1,3,38,38,0.85714
480,0,1,1,4,511,511,1
0,0,1,1,4,20,20,1
480,0,1,1,4,490,490,1
240,0,1,1,4,260,260,1
0,-16,0,0,1,-20,-4,0.42857
480,0,1,1,3,473,473,0.85714
480,-51,0,0,1,487,538,0.42857
240,0,1,1,4,257,257,1
480,-22,0,1,4,489,511,1
480,0,1,1,4,470,470,1
840,-56,0,0,1,780,836,0.42857
0,0,1,1,1,44,44,0.57143
840,93,0,0,4,901,808,0
0,0,1,1,4,20,20,1
840,-24,0,0,1,832,856,0.42857
840,0,1,0,1,860,860,0.42857
480,-6,0,0,1,468,474,0.42857
240,0,1,1,3,218,218,0.85714
840,0,1,0,1,766,766,0.42857
240,-16,0,1,4,234,250,1
240,12,0,0,1,262,250,0.42857
480,-11,0,1,4,460,471,1
0,19,0,0,3,11,-8,0.14286
840,0,1,1,1,832,832,0.57143
840,-59,0,0,1,827,886,0.42857
240,0,1,1,1,233,233,0.57143
480,36,0,0,1,502,466,0.42857
840,0,1,0,1,818,818,0.42857
0,-28,0,0,1,-18,10,0.42857
840,-30,0,0,1,855,885,0.42857
240,0,1,0,1,248,248,0.42857
480,-2,0,0,1,477,479,0.42857
840,38,0,0,1,858,820,0.42857
480,44,0,0,1,508,464,0.42857
840,0,1,1,1,803,803,0.57143
840,-49,0,0,1,804,853,0.42857
480,3,0,1,1,484,481,0.57143
0,88,0,0,4,85,-3,0
240,0,1,0,1,186,186,0.42857
840,31,0,0,1,853,822,0.42857
240,0,1,1,1,258,258,0.57143
480,-17,0,0,1,486,503,0.42857
840,-27,0,1,1,823,850,0.57143
840,27,0,1,1,848,821,0.57143
240,0,1,1,1,268,268,0.57143
240,-37,0,0,1,194,231,0.42857
840,-50,0,0,1,809,859,0.42857
240,0,1,1,1,231,231,0.57143
240,0,1,1,1,225,225,0.57143
0,-6,0,0,1,12,18,0.42857
840,-2,0,1,1,857,859,0.57143
0,13,0,1,1,7,-6,0.57143
0,-43,0,0,1,-18,25,0.42857
480,-26,0,0,1,483,509,0.42857
480,0,1,1,1,484,484,0.57143
840,0,1,1,1,841,841,0.57143
480,-37,0,0,1,446,483,0.42857
840,0,1,1,1,838,838,0.57143
840,0,1,1,1,863,863,0.57143
840,-32,0,0,1,803,835,0.42857
480,-51,0,1,1,434,485,0.57143
840,0,1,0,1,846,846,0.42857
240,50,0,0,1,303,253,0.42857
240,0,1,1,1,278,278,0.57143
240,30,0,0,3,255,225,0.14286
840,0,1,1,1,832,832,0.57143
240,0,1,1,1,235,235,0.57143
480,0,1,1,1,497,497,0.57143
0,-2,0,1,1,2,4,0.57143
240,0,1,1,1,253,253,0.57143
480,20,0,1,3,505,485,0.85714
0,0,1,1,3,17,17,0.85714
840,30,0,0,1,872,842,0.42857
840,0,1,1,3,826,826,0.85714
0,-14,0,0,1,-33,-19,0.42857
0,-36,0,0,1,-42,-6,0.42857
0,0,1,1,4,3,3,1
240,24,0,1,2,277,253,0.71429
0,0,1,1,4,4,4,1
840,0,1,0,1,865,865,0.42857
240,0,1,1,4,251,251,1
840,0,1,1,4,907,907,1
0,-25,0,0,4,-7,18,0
840,-44,0,0,1,806,850,0.42857
480,-9,0,1,1,454,463,0.57143
240,0,1,1,1,216,216,0.57143
240,0,1,1,1,236,236,0.57143
240,0,1,1,3,204,204,0.85714
0,0,1,1,3,-4,-4,0.85714
240,37,0,0,3,238,201,0.14286
840,0,1,0,1,837,837,0.42857
840,-26,0,0,1,805,831,0.42857
0,0,1,1,3,-33,-33,0.85714
0,26,0,0,1,40,14,0.42857
0,0,1,1,2,10,10,0.71429
840,0,1,0,1,801,801,0.42857
0,0,1,1,4,-7,-7,1
0,0,1,1,4,-28,-28,1
840,0,1,1,3,813,813,0.85714
480,0,1,1,3,497,497,0.85714
0,0,1,1,3,-53,-53,0.85714
840,-51,0,0,1,808,859,0.42857
840,-13,0,1,3,842,855,0.85714
840,-44,0,0,1,812,856,0.42857
240,0,1,1,4,243,243,1
0,0,1,1,3,13,13,0.85714
480,2,0,1,3,471,469,0.85714
0,-12,0,0,1,-6,6,0.42857
480,-24,0,1,2,472,496,0.71429
0,13,0,1,3,41,28,0.85714
840,0,1,0,1,841,841,0.42857
0,0,1,1,3,-26,-26,0.85714
240,6,0,1,3,249,243,0.85714
240,0,1,1,3,241,241,0.85714
840,-63,0,1,2,832,895,0.71429
840,0,1,1,1,887,887,0.57143
480,9,0,1,2,481,472,0.71429
240,18,0,1,2,244,226,0.71429
480,-23,0,1,1,477,500,0.57143
0,-36,0,0,1,-15,21,0.42857
480,-7,0,0,1,492,499,0.42857
240,-32,0,1,3,249,281,0.85714
240,0,1,1,3,209,209,0.85714
240,0,1,1,1,240,240,0.57143
0,0,1,1,1,-6,-6,0.57143
840,0,1,0,1,881,881,0.42857
240,0,1,1,1,246,246,0.57143
240,0,1,1,1,252,252,0.57143
240,38,0,0,1,256,218,0.42857
480,37,0,0,1,523,486,0.42857
0,0,1,1,1,-3,-3,0.57143
480,-24,0,0,1,435,459,0.42857
480,47,0,0,1,517,470,0.42857
0,0,1,1,2,-47,-47,0.71429
480,0,1,1,2,529,529,0.71429
480,0,1,1,1,484,484,0.57143
0,0,1,1,2,26,26,0.71429
240,40,0,0,1,255,215,0.42857
0,41,0,0,3,13,-28,0.14286
240,-1,0,1,2,269,270,0.71429
480,0,1,1,1,503,503,0.57143
0,0,1,1,1,-31,-31,0.57143
840,13,0,0,1,847,834,0.42857
840,-21,0,1,1,846,867,0.57143
0,0,1,1,2,17,17,0.71429
840,0,1,1,2,797,797,0.71429
240,-2,0,1,2,222,224,0.71429
840,0,1,1,2,830,830,0.71429
240,0,1,1,2,244,244,0.71429
240,-15,0,1,2,231,246,0.71429
0,4,0,1,2,17,13,0.71429
240,6,0,1,2,193,187,0.71429
240,0,1,1,2,210,210,0.71429
240,87,0,0,3,293,206,0.14286
480,5,0,1,2,501,496,0.71429
840,-13,0,1,2,831,844,0.71429
0,67,0,0,3,27,-40,0.14286
840,0,1,1,1,820,820,0.57143
240,10,0,1,2,233,223,0.71429
840,0,1,1,2,830,830,0.71429
240,-33,0,1,2,246,279,0.71429
480,0,1,1,2,500,500,0.71429
0,-49,0,0,3,-39,10,0.14286
240,0,1,1,2,223,223,0.71429
840,0,1,1,2,839,839,0.71429
480,-41,0,1,2,467,508,0.71429
480,19,0,1,2,486,467,0.71429
480,-20,0,1,2,498,518,0.71429
840,14,0,1,2,837,823,0.71429
0,0,1,1,3,2,2,0.85714
840,0,1,1,2,869,869,0.71429
240,0,1,1,2,235,235,0.71429
240,0,1,1,2,269,269,0.71429
840,39,0,1,2,861,822,0.71429
840,0,1,1,2,826,826,0.71429
840,0,1,1,2,804,804,0.71429
0,0,1,1,2,14,14,0.71429
480,4,0,1,2,479,475,0.71429
0,-15,0,1,2,-1,14,0.71429
840,0,1,1,2,890,890,0.71429
480,6,0,1,1,485,479,0.57143
240,0,1,1,2,280,280,0.71429
0,-26,0,0,3,-44,-18,0.14286
840,-32,0,0,1,818,850,0.42857
0,0,1,1,2,3,3,0.71429
480,0,1,1,2,474,474,0.71429
240,0,1,1,2,233,233,0.71429
480,0,1,1,2,463,463,0.71429
840,0,1,1,2,857,857,0.71429
240,-5,0,1,2,246,251,0.71429
240,3,0,1,2,246,243,0.71429
480,0,1,1,2,450,450,0.71429
0,0,1,1,2,55,55,0.71429
0,-3,0,1,1,-16,-13,0.57143
480,-9,0,1,2,482,491,0.71429
480,0,1,1,2,487,487,0.71429
0,0,1,1,1,-48,-48,0.57143
480,0,1,1,2,508,508,0.71429
840,0,1,1,2,850,850,0.71429
480,-12,0,1,1,478,490,0.57143
0,7,0,1,1,-7,-14,0.57143
240,0,1,1,2,220,220,0.71429
0,0,1,1,3,31,31,0.85714
840,0,1,1,3,819,819,0.85714
840,-14,0,1,3,811,825,0.85714
840,25,0,1,3,850,825,0.85714
240,0,1,1,3,264,264,0.85714
240,-6,0,1,3,235,241,0.85714
240,0,1,1,3,197,197,0.85714
840,0,1,1,2,846,846,0.71429
0,0,1,1,2,-13,-13,0.71429
840,-4,0,1,3,834,838,0.85714
840,32,0,1,2,862,830,0.71429
840,0,1,1,3,876,876,0.85714
840,48,0,1,3,891,843,0.85714
0,0,1,1,3,-28,-28,0.85714
240,0,1,1,3,258,258,0.85714
480,0,1,1,3,457,457,0.85714
840,-5,0,1,3,860,865,0.85714
480,0,1,1,3,507,507,0.85714
240,0,1,1,2,237,237,0.71429
480,0,1,1,2,467,467,0.71429
840,-5,0,1,1,858,863,0.57143
840,0,1,1,2,842,842,0.71429
840,-34,0,1,2,831,865,0.71429
480,0,1,1,2,501,501,0.71429
480,0,1,1,1,471,471,0.57143
480,0,1,1,1,484,484,0.57143
840,0,1,1,1,835,835,0.57143
840,0,1,1,2,856,856,0.71429
240,0,1,1,2,269,269,0.71429
0,22,0,0,2,8,-14,0.28571
0,-33,0,0,2,4,37,0.28571
840,0,1,1,3,839,839,0.85714
840,0,1,0,1,873,873,0.42857
480,12,0,1,1,480,468,0.57143
240,86,0,0,2,302,216,0.28571
0,-16,0,0,3,-48,-32,0.14286
480,0,1,1,2,519,519,0.71429
0,0,1,1,1,19,19,0.57143
840,0,1,1,1,856,856,0.57143
240,0,1,1,1,260,260,0.57143
840,0,1,1,1,879,879,0.57143
480,0,1,1,1,478,478,0.57143
480,0,1,1,1,482,482,0.57143
240,0,1,1,2,252,252,0.71429
840,0,1,1,2,826,826,0.71429
0,33,0,1,2,12,-21,0.71429
0,41,0,0,2,22,-19,0.28571
480,-57,0,0,2,480,537,0.28571
840,0,1,1,2,799,799,0.71429
240,-26,0,0,1,207,233,0.42857
480,-29,0,0,1,466,495,0.42857
0,0,1,1,2,-7,-7,0.71429
240,39,0,1,2,285,246,0.71429
0,-25,0,0,3,-28,-3,0.14286
240,-18,0,0,1,256,274,0.42857
240,-42,0,0,1,225,267,0.42857
480,0,1,1,1,526,526,0.57143
240,0,1,1,1,286,286,0.57143
0,24,0,0,3,-22,-46,0.14286
840,16,0,1,1,836,820,0.57143
480,0,1,0,1,526,526,0.42857
240,-14,0,1,1,237,251,0.57143
0,0,1,1,1,21,21,0.57143
240,0,1,1,2,256,256,0.71429
0,-62,0,0,3,-29,33,0.14286
0,0,1,1,2,-12,-12,0.71429
480,-49,0,1,1,431,480,0.57143
480,-19,0,1,2,502,521,0.71429
840,14,0,1,1,836,822,0.57143
480,0,1,1,2,448,448,0.71429
840,0,1,1,2,842,842,0.71429
0,0,1,1,2,-18,-18,0.71429
840,0,1,1,1,897,897,0.57143
480,-16,0,1,1,490,506,0.57143
0,0,1,1,3,8,8,0.85714
0,0,1,1,4,21,21,1
840,-29,0,1,3,821,850,0.85714
840,-24,0,1,3,858,882,0.85714
0,30,0,1,2,10,-20,0.71429
840,-5,0,1,2,849,854,0.71429
0,-9,0,1,2,1,10,0.71429
0,0,1,1,3,-29,-29,0.85714
480,0,1,1,3,511,511,0.85714
240,19,0,1,3,267,248,0.85714
0,0,1,1,3,-18,-18,0.85714
840,-16,0,1,2,840,856,0.71429
840,4,0,1,3,823,819,0.85714
480,28,0,1,2,510,482,0.71429
840,20,0,1,3,832,812,0.85714
840,0,1,1,3,809,809,0.85714
840,16,0,1,3,824,808,0.85714
840,65,0,1,3,867,802,0.85714
0,0,1,1,3,11,11,0.85714
840,-11,0,1,3,816,827,0.85714
480,0,1,1,3,479,479,0.85714
0,0,1,1,4,-41,-41,1
240,14,0,1,4,245,231,1
0,34,0,0,3,21,-13,0.14286
480,21,0,1,3,473,452,0.85714
840,27,0,1,3,833,806,0.85714
0,0,1,1,3,23,23,0.85714
840,73,0,0,1,861,788,0.42857
0,2,0,1,3,-9,-11,0.85714
480,-2,0,1,3,493,495,0.85714
0,0,1,1,3,-2,-2,0.85714
240,-10,0,1,3,247,257,0.85714
480,0,1,1,3,467,467,0.85714
840,-33,0,0,1,819,852,0.42857
240,0,1,1,3,222,222,0.85714
480,-17,0,1,3,491,508,0.85714
240,0,1,1,3,267,267,0.85714
840,32,0,1,3,840,808,0.85714
0,0,1,1,3,45,45,0.85714
840,23,0,1,2,860,837,0.71429
240,11,0,1,2,228,217,0.71429
840,48,0,0,1,831,783,0.42857
840,0,1,1,3,807,807,0.85714
240,0,1,1,3,245,245,0.85714
240,-3,0,1,3,239,242,0.85714
840,-31,0,1,3,801,832,0.85714
240,0,1,1,3,267,267,0.85714
480,0,1,1,3,489,489,0.85714
0,0,1,0,3,29,29,0.14286
0,0,1,1,3,-27,-27,0.85714
840,16,0,1,2,866,850,0.71429
480,-27,0,1,1,463,490,0.57143
240,0,1,1,1,241,241,0.57143
840,0,1,1,2,824,824,0.71429
0,0,1,1,1,-35,-35,0.57143
480,23,0,1,3,490,467,0.85714
480,0,1,1,3,493,493,0.85714
840,-9,0,1,2,805,814,0.71429
240,0,1,1,2,228,228,0.71429
0,0,1,1,2,-41,-41,0.71429
840,-66,0,0,1,806,872,0.42857
0,0,1,1,3,-1,-1,0.85714
0,73,0,0,4,36,-37,0
240,48,0,0,4,233,185,0
240,-8,0,1,1,232,240,0.57143
840,7,0,1,1,842,835,0.57143
840,0,1,1,1,815,815,0.57143
480,40,0,0,1,507,467,0.42857
480,0,1,1,1,464,464,0.57143
240,3,0,1,2,226,223,0.71429
480,0,1,1,1,469,469,0.57143
840,2,0,1,1,866,864,0.57143
840,0,1,1,1,837,837,0.57143
840,0,1,1,1,846,846,0.57143
480,16,0,1,1,478,462,0.57143
0,-7,0,0,1,9,16,0.42857
0,-50,0,0,4,-33,17,0
840,0,1,1,1,845,845,0.57143
0,0,1,1,1,-10,-10,0.57143
240,13,0,1,2,254,241,0.71429
0,-21,0,0,1,6,27,0.42857
480,-18,0,0,1,492,510,0.42857
840,13,0,1,2,854,841,0.71429
0,67,0,0,4,45,-22,0
480,29,0,1,3,502,473,0.85714
0,0,1,1,3,15,15,0.85714
240,4,0,1,3,254,250,0.85714
840,39,0,1,3,893,854,0.85714
0,47,0,0,4,46,-1,0
240,0,1,1,4,213,213,1
240,-24,0,1,3,219,243,0.85714
0,-11,0,0,4,-7,4,0
0,0,1,1,2,37,37,0.71429
840,0,1,1,2,838,838,0.71429
240,0,1,1,1,240,240,0.57143
840,0,1,1,2,900,900,0.71429
480,0,1,1,2,446,446,0.71429
240,33,0,1,2,257,224,0.71429
0,0,1,1,2,-8,-8,0.71429
840,-30,0,1,1,815,845,0.57143
840,0,1,1,1,821,821,0.57143
0,0,1,1,1,20,20,0.57143
0,0,1,1,1,-0,-0,0.57143
240,0,1,1,1,273,273,0.57143
0,0,1,1,1,38,38,0.57143
840,0,1,1,1,836,836,0.57143
0,-49,0,0,4,-17,32,0
480,0,1,1,1,525,525,0.57143
240,-66,0,0,4,231,297,0
840,0,1,1,1,871,871,0.57143
0,36,0,1,4,40,4,1
240,10,0,1,4,241,231,1
840,0,1,1,4,887,887,1
840,0,1,1,4,868,868,1
240,0,1,1,4,231,231,1
0,0,1,1,4,30,30,1
480,0,1,1,3,525,525,0.85714
240,0,1,1,3,210,210,0.85714
0,12,0,1,4,5,-7,1
0,-4,0,0,4,-32,-28,0
240,0,1,1,3,250,250,0.85714
0,0,1,1,3,22,22,0.85714
0,0,1,1,3,-69,-69,0.85714
480,0,1,1,3,498,498,0.85714
0,0,1,1,3,4,4,0.85714
840,-78,0,1,3,798,876,0.85714
240,35,0,1,3,264,229,0.85714
480,0,1,1,3,483,483,0.85714
240,0,1,1,3,228,228,0.85714
240,0,1,1,3,253,253,0.85714
480,-11,0,1,3,487,498,0.85714
240,0,1,1,3,209,209,0.85714
480,3,0,1,3,485,482,0.85714
240,-4,0,1,3,228,232,0.85714
480,-2,0,1,3,471,473,0.85714
480,0,1,1,1,509,509,0.57143
240,116,0,0,4,296,180,0
0,0,1,1,3,8,8,0.85714
480,0,1,1,3,522,522,0.85714
480,-45,0,1,3,442,487,0.85714
240,0,1,1,3,229,229,0.85714
0,0,1,1,3,18,18,0.85714
480,61,0,1,3,517,456,0.85714
0,33,0,0,4,34,1,0
0,21,0,0,4,12,-9,0
240,-2,0,1,3,247,249,0.85714
240,-16,0,1,3,250,266,0.85714
840,0,1,0,3,854,854,0.14286
240,-8,0,1,3,257,265,0.85714
240,21,0,1,3,260,239,0.85714
240,2,0,1,3,233,231,0.85714
840,0,1,1,3,800,800,0.85714
480,0,1,1,3,524,524,0.85714
840,-12,0,1,3,842,854,0.85714
240,0,1,1,3,205,205,0.85714
240,-4,0,1,3,222,226,0.85714
0,-7,0,1,3,24,31,0.85714
840,-7,0,1,2,830,837,0.71429
840,24,0,1,3,857,833,0.85714
240,0,1,1,3,255,255,0.85714
0,0,1,1,3,-14,-14,0.85714
480,0,1,1,3,471,471,0.85714
840,0,1,1,3,817,817,0.85714
240,-4,0,1,3,202,206,0.85714
480,0,1,1,2,494,494,0.71429
480,59,0,0,3,490,431,0.14286
480,0,1,1,3,489,489,0.85714
480,0,1,1,1,472,472,0.57143
840,0,1,1,1,816,816,0.57143
0,-5,0,0,1,-15,-10,0.42857
0,0,1,1,1,21,21,0.57143
480,0,1,1,3,469,469,0.85714
480,0,1,1,3,475,475,0.85714
0,43,0,0,4,23,-20,0
480,12,0,1,3,485,473,0.85714
840,0,1,1,1,832,832,0.57143
240,0,1,1,1,314,314,0.57143
240,0,1,1,1,274,274,0.57143
840,-11,0,1,1,829,840,0.57143
840,-30,0,1,1,840,870,0.57143
0,0,1,1,1,-31,-31,0.57143
240,0,1,1,1,280,280,0.57143
480,0,1,1,1,524,524,0.57143
480,-29,0,1,1,454,483,0.57143
480,31,0,1,1,496,465,0.57143
0,-47,0,0,4,-46,1,0
480,12,0,1,1,491,479,0.57143
0,0,1,1,2,-16,-16,0.71429
240,95,0,0,4,276,181,0
0,0,1,1,1,-16,-16,0.57143
480,0,1,1,1,496,496,0.57143
240,0,1,1,1,239,239,0.57143
0,0,1,1,3,-31,-31,0.85714
240,16,0,1,3,232,216,0.85714
840,26,0,1,3,855,829,0.85714
240,0,1,1,3,213,213,0.85714
480,5,0,1,3,459,454,0.85714
0,20,0,0,1,-5,-25,0.42857
480,-38,0,0,1,449,487,0.42857
240,0,1,1,1,239,239,0.57143
0,0,1,1,2,38,38,0.71429
240,-25,0,1,3,212,237,0.85714
0,0,1,1,3,5,5,0.85714
240,-19,0,1,3,236,255,0.85714
240,0,1,1,3,278,278,0.85714
0,0,1,1,3,26,26,0.85714
480,24,0,0,1,489,465,0.42857
480,-42,0,0,1,450,492,0.42857
0,-47,0,0,1,-3,44,0.42857
0,-8,0,0,1,-9,-1,0.42857
240,0,1,1,3,182,182,0.85714
240,-8,0,1,2,217,225,0.71429
240,0,1,1,2,213,213,0.71429
0,0,1,1,2,-10,-10,0.71429
0,0,1,1,2,-10,-10,0.71429
0,0,1,1,3,-41,-41,0.85714
240,0,1,1,4,272,272,1
480,0,1,0,1,507,507,0.42857
480,0,1,0,1,496,496,0.42857
240,4,0,1,3,260,256,0.85714
240,0,1,1,3,246,246,0.85714
840,0,1,1,1,830,830,0.57143
840,48,0,0,1,886,838,0.42857
240,-49,0,0,1,213,262,0.42857
480,-10,0,0,1,473,483,0.42857
240,0,1,1,3,243,243,0.85714
840,-25,0,0,1,836,861,0.42857
0,-23,0,0,1,17,40,0.42857
480,-42,0,0,1,464,506,0.42857
480,0,1,0,1,455,455,0.42857
840,27,0,0,1,842,815,0.42857
480,0,1,0,1,493,493,0.42857
840,0,1,0,1,828,828,0.42857
480,-7,0,0,1,487,494,0.42857
0,0,1,1,3,-5,-5,0.85714
480,0,1,0,1,445,445,0.42857
840,2,0,0,1,855,853,0.42857
480,22,0,1,3,491,469,0.85714
840,32,0,0,1,864,832,0.42857
0,0,1,1,3,-13,-13,0.85714
480,39,0,1,3,472,433,0.85714
0,0,1,1,3,-2,-2,0.85714
840,0,1,1,3,836,836,0.85714
240,0,1,1,3,264,264,0.85714
840,0,1,1,3,847,847,0.85714
480,54,0,1,3,534,480,0.85714
840,0,1,0,1,835,835,0.42857
0,0,1,1,3,10,10,0.85714
480,-42,0,1,3,474,516,0.85714
480,43,0,1,3,483,440,0.85714
240,-18,0,0,1,172,190,0.42857
240,45,0,1,3,253,208,0.85714
480,36,0,0,1,478,442,0.42857
480,48,0,1,2,518,470,0.71429
480,0,1,1,2,480,480,0.71429
240,24,0,1,3,239,215,0.85714
480,43,0,0,1,473,430,0.42857
480,0,1,1,2,479,479,0.71429
0,0,1,0,1,-27,-27,0.42857
480,0,1,1,1,477,477,0.57143
0,6,0,1,2,-18,-24,0.71429
240,0,1,1,2,286,286,0.71429
0,13,0,1,3,22,9,0.85714
0,0,1,1,3,12,12,0.85714
0,-20,0,0,3,-14,6,0.14286
0,0,1,1,2,45,45,0.71429
840,-13,0,1,2,849,862,0.71429
0,2,0,1,4,-5,-7,1
0,-42,0,0,2,-19,23,0.28571
480,5,0,1,1,460,455,0.57143
840,12,0,1,1,853,841,0.57143
480,0,1,1,1,488,488,0.57143
480,19,0,1,1,493,474,0.57143
480,10,0,1,1,484,474,0.57143
840,0,1,1,1,802,802,0.57143
480,0,1,1,2,460,460,0.71429
480,67,0,0,1,531,464,0.42857
840,-38,0,1,1,791,829,0.57143
840,0,1,1,1,831,831,0.57143
840,0,1,0,1,845,845,0.42857
0,8,0,1,2,4,-4,0.71429
240,-31,0,0,1,222,253,0.42857
240,0,1,1,1,229,229,0.57143
240,0,1,1,3,223,223,0.85714
0,0,1,1,3,-2,-2,0.85714
480,0,1,1,3,468,468,0.85714
0,0,1,1,3,6,6,0.85714
480,0,1,1,3,472,472,0.85714
840,0,1,1,3,855,855,0.85714
480,0,1,1,3,488,488,0.85714
240,0,1,1,3,226,226,0.85714
480,0,1,1,3,454,454,0.85714
240,-24,0,1,3,245,269,0.85714
240,-6,0,1,2,249,255,0.71429
480,-71,0,0,1,459,530,0.42857
840,0,1,1,2,849,849,0.71429
840,0,1,1,2,832,832,0.71429
0,0,1,1,2,8,8,0.71429
240,-1,0,1,2,208,209,0.71429
480,0,1,1,2,449,449,0.71429
480,-47,0,0,1,447,494,0.42857
240,0,1,1,2,250,250,0.71429
480,-13,0,1,1,437,450,0.57143
0,15,0,0,1,26,11,0.42857
480,0,1,1,1,460,460,0.57143
480,-34,0,1,1,465,499,0.57143
0,0,1,0,1,17,17,0.42857
240,0,1,1,2,279,279,0.71429
0,0,1,1,2,-7,-7,0.71429
480,0,1,1,2,500,500,0.71429
480,-9,0,1,3,476,485,0.85714
240,27,0,1,3,250,223,0.85714
840,-26,0,1,3,839,865,0.85714
840,24,0,1,3,819,795,0.85714
840,57,0,1,3,861,804,0.85714
840,0,1,1,2,845,845,0.71429
240,-9,0,1,2,245,254,0.71429
480,0,1,1,3,495,495,0.85714
480,-14,0,1,3,472,486,0.85714
480,31,0,1,2,483,452,0.71429
0,0,1,1,3,18,18,0.85714
840,0,1,1,3,851,851,0.85714
0,0,1,1,4,-24,-24,1
0,0,1,1,3,2,2,0.85714
240,0,1,1,4,223,223,1
240,-96,0,0,1,199,295,0.42857
240,0,1,1,2,242,242,0.71429
840,-28,0,0,1,840,868,0.42857
0,-26,0,0,4,-14,12,0
0,0,1,1,3,-1,-1,0.85714
240,0,1,1,2,223,223,0.71429
480,-25,0,1,2,438,463,0.71429
240,14,0,1,2,234,220,0.71429
840,0,1,0,1,858,858,0.42857
240,67,0,0,4,266,199,0
840,0,1,1,3,823,823,0.85714
840,58,0,0,1,870,812,0.42857
840,-1,0,0,1,826,827,0.42857
480,0,1,1,2,513,513,0.71429
480,51,0,0,3,504,453,0.14286
240,0,1,1,2,226,226,0.71429
0,-30,0,0,4,-20,10,0
0,54,0,0,4,11,-43,0
0,0,1,1,2,-19,-19,0.71429
0,0,1,0,4,0,0,0
840,0,1,1,3,845,845,0.85714
480,0,1,1,2,470,470,0.71429
840,-34,0,1,2,827,861,0.71429
480,-36,0,1,3,474,510,0.85714
840,53,0,1,3,879,826,0.85714
480,89,0,1,4,516,427,1
840,0,1,0,4,822,822,0
240,0,1,0,1,263,263,0.42857
840,14,0,0,1,844,830,0.42857
0,34,0,0,4,30,-4,0
480,45,0,0,1,497,452,0.42857
840,46,0,0,1,876,830,0.42857
840,0,1,0,1,822,822,0.42857
240,37,0,0,3,279,242,0.14286
480,0,1,0,1,488,488,0.42857
240,0,1,0,1,173,173,0.42857
840,26,0,0,1,843,817,0.42857
240,14,0,0,1,236,222,0.42857
240,-8,0,0,1,223,231,0.42857
0,0,1,1,3,31,31,0.85714
840,14,0,1,2,871,857,0.71429
240,82,0,0,4,296,214,0
0,-23,0,0,4,-15,8,0
480,0,1,1,4,481,481,1
240,0,1,1,4,223,223,1
0,-18,0,0,4,-18,-0,0
840,0,1,1,3,865,865,0.85714
240,0,1,1,3,205,205,0.85714
480,-3,0,1,3,485,488,0.85714
0,0,1,1,3,13,13,0.85714
0,0,1,1,3,25,25,0.85714
240,0,1,1,3,264,264,0.85714
0,-16,0,1,2,-14,2,0.71429
0,0,1,1,2,8,8,0.71429
480,45,0,1,2,525,480,0.71429
240,0,1,1,2,212,212,0.71429
0,-3,0,1,2,-7,-4,0.71429
0,-7,0,1,2,24,31,0.71429
480,0,1,1,2,506,506,0.71429
840,-3,0,1,2,864,867,0.71429
840,0,1,1,2,843,843,0.71429
480,-19,0,1,1,468,487,0.57143
840,0,1,1,4,850,850,1
240,0,1,1,3,228,228,0.85714
0,30,0,0,4,-8,-38,0
840,10,0,0,4,861,851,0
480,-1,0,0,4,491,492,0
240,0,1,1,3,239,239,0.85714
0,0,1,1,2,39,39,0.71429
840,-13,0,1,2,829,842,0.71429
0,72,0,0,4,30,-42,0
840,0,1,1,3,832,832,0.85714
0,-26,0,0,4,-2,24,0
840,0,1,1,3,832,832,0.85714
840,-76,0,0,4,798,874,0
840,41,0,1,2,873,832,0.71429
240,49,0,0,4,261,212,0
240,39,0,0,1,245,206,0.42857
0,-17,0,0,4,-19,-2,0
240,-13,0,0,4,243,256,0
840,0,1,0,1,835,835,0.42857
840,32,0,0,4,854,822,0
480,-5,0,1,3,475,480,0.85714
480,0,1,1,3,504,504,0.85714
240,0,1,1,2,227,227,0.71429
0,0,1,1,2,-8,-8,0.71429
240,-6,0,1,2,230,236,0.71429
480,-19,0,1,2,470,489,0.71429
240,-59,0,1,2,188,247,0.71429
840,0,1,1,3,849,849,0.85714
480,0,1,1,2,513,513,0.71429
0,0,1,1,2,29,29,0.71429
480,0,1,1,2,490,490,0.71429
240,-21,0,1,2,181,202,0.71429
240,24,0,1,2,249,225,0.71429
0,0,1,1,3,22,22,0.85714
240,-74,0,0,4,207,281,0
840,-17,0,1,2,840,857,0.71429
840,0,1,1,2,838,838,0.71429
840,36,0,1,2,858,822,0.71429
