480,-28,0,1,2,439,467,0.71429
480,5,0,1,2,498,493,0.71429
240,0,1,1,3,231,231,0.85714
0,0,1,1,4,-18,-18,1
240,0,1,0,2,256,256,0.28571
840,57,0,0,4,861,804,0
840,-48,0,0,3,836,884,0.14286
840,0,1,0,1,844,844,0.42857
0,0,1,1,2,-11,-11,0.71429
0,1,0,1,3,-10,-11,0.85714
0,13,0,0,3,22,9,0.14286
840,0,1,0,2,847,847,0.28571
0,-42,0,0,4,-42,0,0
840,0,1,1,1,840,840,0.57143
480,0,1,1,2,470,470,0.71429
0,0,1,1,3,-19,-19,0.85714
840,0,1,0,1,852,852,0.42857
480,0,1,0,1,476,476,0.42857
0,0,1,0,1,14,14,0.42857
840,-26,0,0,2,845,871,0.28571
240,39,0,0,3,248,209,0.14286
0,-44,0,0,4,-30,14,0
240,-39,0,0,2,251,290,0.28571
0,7,0,0,2,-9,-16,0.28571
240,0,1,0,1,245,245,0.42857
240,0,1,0,2,233,233,0.28571
480,0,1,1,2,460,460,0.71429
840,-4,0,1,3,831,835,0.85714
840,0,1,1,2,832,832,0.71429
840,0,1,1,2,857,857,0.71429
240,-11,0,0,1,238,249,0.42857
480,-67,0,0,2,470,537,0.28571
840,-1,0,0,3,823,824,0.14286
480,0,1,1,3,471,471,0.85714
0,-60,0,0,4,-33,27,0
0,0,1,1,1,-6,-6,0.57143
480,0,1,1,2,472,472,0.71429
240,0,1,0,1,244,244,0.42857
480,29,0,0,2,478,449,0.28571
840,65,0,0,4,914,849,0
840,0,1,0,1,810,810,0.42857
480,59,0,0,2,496,437,0.28571
0,0,1,1,2,-32,-32,0.71429
0,24,0,0,3,46,22,0.14286
840,0,1,0,1,863,863,0.42857
240,0,1,1,1,251,251,0.57143
240,16,0,0,2,209,193,0.28571
0,0,1,1,2,50,50,0.71429
480,0,1,1,3,501,501,0.85714
0,0,1,1,4,-17,-17,1
840,0,1,1,2,839,839,0.71429
240,0,1,1,2,228,228,0.71429
480,0,1,1,2,470,470,0.71429
240,10,0,1,2,260,250,0.71429
840,0,1,1,2,856,856,0.71429
0,20,0,0,3,12,-8,0.14286
840,-45,0,0,3,833,878,0.14286
0,0,1,0,1,12,12,0.42857
240,0,1,1,2,234,234,0.71429
0,0,1,1,3,23,23,0.85714
240,0,1,1,3,245,245,0.85714
240,0,1,1,3,224,224,0.85714
840,-46,0,0,4,828,874,0
840,-7,0,0,1,828,835,0.42857
480,-35,0,0,2,413,448,0.28571
0,-4,0,1,3,1,5,0.85714
840,0,1,0,3,879,879,0.14286
480,-46,0,0,3,449,495,0.14286
0,18,0,0,4,5,-13,0
840,-1,0,0,1,838,839,0.42857
240,0,1,1,2,199,199,0.71429
240,0,1,0,2,206,206,0.28571
480,-18,0,0,4,457,475,0
0,0,1,1,3,-7,-7,0.85714
480,4,0,1,2,481,477,0.71429
840,0,1,1,1,825,825,0.57143
480,0,1,1,2,498,498,0.71429
240,-14,0,1,3,245,259,0.85714
480,-41,0,0,3,465,506,0.14286
240,-37,0,0,4,242,279,0
0,-67,0,0,4,-47,20,0
840,16,0,1,2,878,862,0.71429
480,0,1,1,3,482,482,0.85714
840,0,1,0,2,860,860,0.28571
0,-71,0,0,4,-29,42,0
840,29,0,0,1,866,837,0.42857
480,32,0,0,1,470,438,0.42857
240,0,1,1,2,241,241,0.71429
0,0,1,0,2,8,8,0.28571
240,-68,0,0,3,219,287,0.14286
480,-7,0,1,2,502,509,0.71429
480,-39,0,0,4,487,526,0
0,12,0,0,4,-3,-15,0
840,0,1,0,4,825,825,0
0,0,1,0,1,-7,-7,0.42857
240,16,0,0,1,235,219,0.42857
480,3,0,1,2,484,481,0.71429
840,59,0,0,3,873,814,0.14286
240,0,1,1,2,257,257,0.71429
0,0,1,1,2,-18,-18,0.71429
240,-19,0,1,2,235,254,0.71429
840,0,1,1,2,830,830,0.71429
480,4,0,1,2,481,477,0.71429
480,64,0,0,3,506,442,0.14286
0,23,0,0,3,26,3,0.14286
240,0,1,1,2,198,198,0.71429
240,0,1,1,2,253,253,0.71429
840,-18,0,1,1,814,832,0.57143
240,0,1,1,2,244,244,0.71429
480,-53,0,0,3,463,516,0.14286
240,40,0,0,3,260,220,0.14286
240,0,1,0,2,197,197,0.28571
0,-26,0,0,3,-35,-9,0.14286
480,24,0,0,1,486,462,0.42857
480,-61,0,0,2,439,500,0.28571
240,0,1,1,2,266,266,0.71429
840,8,0,1,1,832,824,0.57143
840,0,1,1,1,825,825,0.57143
0,49,0,0,4,6,-43,0
0,-14,0,0,4,10,24,0
840,38,0,0,1,831,793,0.42857
0,0,1,1,1,6,6,0.57143
840,-11,0,1,1,827,838,0.57143
480,7,0,0,2,500,493,0.28571
840,-49,0,0,2,822,871,0.28571
480,0,1,1,1,467,467,0.57143
240,0,1,1,1,247,247,0.57143
240,21,0,0,2,252,231,0.28571
480,0,1,1,3,487,487,0.85714
240,0,1,1,3,227,227,0.85714
0,0,1,1,4,2,2,1
240,-62,0,0,3,201,263,0.14286
840,-5,0,0,1,823,828,0.42857
840,-1,0,1,1,829,830,0.57143
480,36,0,0,2,488,452,0.28571
480,11,0,0,3,481,470,0.14286
0,17,0,0,3,27,10,0.14286
240,-4,0,0,1,238,242,0.42857
240,14,0,0,2,264,250,0.28571
480,-31,0,1,3,462,493,0.85714
480,0,1,1,2,448,448,0.71429
0,0,1,1,4,3,3,1
0,0,1,1,4,21,21,1
480,0,1,1,4,455,455,1
480,0,1,1,4,497,497,1
840,-9,0,1,4,838,847,1
240,0,1,1,4,249,249,1
240,0,1,1,4,253,253,1
840,-43,0,1,2,806,849,0.71429
840,9,0,1,2,854,845,0.71429
0,0,1,1,3,16,16,0.85714
240,0,1,1,3,264,264,0.85714
0,-34,0,0,4,-10,24,0
240,0,1,1,4,225,225,1
840,0,1,1,4,870,870,1
0,-4,0,1,4,-1,3,1
240,-3,0,0,1,266,269,0.42857
0,0,1,1,4,-3,-3,1
240,-54,0,0,4,181,235,0
840,0,1,0,2,837,837,0.28571
0,0,1,1,2,-12,-12,0.71429
840,0,1,0,1,846,846,0.42857
480,15,0,1,2,483,468,0.71429
240,-32,0,0,3,226,258,0.14286
840,-2,0,1,2,830,832,0.71429
840,0,1,1,2,841,841,0.71429
840,38,0,0,3,868,830,0.14286
240,-6,0,1,2,265,271,0.71429
840,0,1,1,1,807,807,0.57143
0,0,1,1,1,3,3,0.57143
840,0,1,1,1,822,822,0.57143
480,0,1,1,2,495,495,0.71429
240,-38,0,0,3,227,265,0.14286
840,-35,0,0,3,835,870,0.14286
0,0,1,0,1,-2,-2,0.42857
240,0,1,1,3,250,250,0.85714
480,0,1,1,4,481,481,1
840,0,1,1,2,840,840,0.71429
480,0,1,1,2,467,467,0.71429
240,0,1,1,2,241,241,0.71429
240,19,0,1,2,256,237,0.71429
840,0,1,1,1,857,857,0.57143
480,0,1,1,2,473,473,0.71429
240,31,0,0,3,255,224,0.14286
840,0,1,0,2,829,829,0.28571
0,-17,0,0,3,-6,11,0.14286
240,0,1,0,1,233,233,0.42857
240,-20,0,0,2,222,242,0.28571
480,0,1,1,2,520,520,0.71429
240,20,0,0,3,216,196,0.14286
240,0,1,0,3,249,249,0.14286
0,0,1,1,3,33,33,0.85714
840,0,1,1,3,787,787,0.85714
240,0,1,0,2,274,274,0.28571
240,17,0,0,2,265,248,0.28571
240,-1,0,0,2,228,229,0.28571
240,-18,0,0,3,195,213,0.14286
840,0,1,1,3,819,819,0.85714
0,0,1,1,3,-8,-8,0.85714
840,0,1,1,2,857,857,0.71429
0,-83,0,0,4,-41,42,0
480,0,1,0,1,480,480,0.42857
0,0,1,0,1,-7,-7,0.42857
0,-50,0,0,2,-29,21,0.28571
0,0,1,0,2,29,29,0.28571
0,11,0,0,3,4,-7,0.14286
840,0,1,1,2,826,826,0.71429
480,-22,0,1,2,464,486,0.71429
240,0,1,1,2,241,241,0.71429
480,23,0,0,3,496,473,0.14286
0,0,1,0,2,14,14,0.28571
0,0,1,1,2,-40,-40,0.71429
0,0,1,1,3,-1,-1,0.85714
480,-37,0,0,3,458,495,0.14286
240,-32,0,0,3,223,255,0.14286
0,38,0,0,3,44,6,0.14286
480,0,1,0,1,473,473,0.42857
840,0,1,0,1,819,819,0.42857
240,0,1,1,3,257,257,0.85714
840,-13,0,1,3,832,845,0.85714
480,29,0,0,3,489,460,0.14286
840,-33,0,0,2,826,859,0.28571
840,0,1,1,2,797,797,0.71429
840,0,1,1,2,831,831,0.71429
480,-54,0,0,3,450,504,0.14286
840,-3,0,1,2,855,858,0.71429
480,0,1,0,3,483,483,0.14286
480,58,0,0,4,519,461,0
240,0,1,1,2,221,221,0.71429
840,-19,0,0,2,840,859,0.28571
240,-12,0,0,1,211,223,0.42857
480,11,0,0,1,480,469,0.42857
840,0,1,1,2,876,876,0.71429
240,-3,0,1,3,254,257,0.85714
0,0,1,1,4,26,26,1
840,0,1,1,3,852,852,0.85714
240,0,1,1,2,257,257,0.71429
480,0,1,1,2,476,476,0.71429
0,10,0,0,3,2,-8,0.14286
480,0,1,1,2,490,490,0.71429
840,0,1,1,2,831,831,0.71429
240,24,0,0,3,295,271,0.14286
840,0,1,1,2,844,844,0.71429
240,35,0,0,4,243,208,0
240,-55,0,0,4,216,271,0
480,0,1,0,1,483,483,0.42857
240,0,1,0,1,277,277,0.42857
240,57,0,0,3,302,245,0.14286
480,0,1,1,2,453,453,0.71429
840,0,1,0,1,866,866,0.42857
480,-14,0,0,1,460,474,0.42857
480,-9,0,0,1,498,507,0.42857
840,0,1,1,2,802,802,0.71429
840,0,1,0,1,852,852,0.42857
840,0,1,1,2,849,849,0.71429
480,0,1,0,1,472,472,0.42857
240,0,1,1,2,235,235,0.71429
240,34,0,0,2,233,199,0.28571
0,0,1,0,2,21,21,0.28571
0,0,1,0,2,-17,-17,0.28571
840,4,0,1,3,877,873,0.85714
480,0,1,1,3,486,486,0.85714
840,0,1,1,2,831,831,0.71429
0,51,0,0,3,40,-11,0.14286
240,-70,0,0,4,194,264,0
0,-29,0,0,4,-0,29,0
0,-8,0,0,1,8,16,0.42857
0,-23,0,0,3,-1,22,0.14286
0,0,1,1,1,-9,-9,0.57143
840,75,0,0,4,891,816,0
240,0,1,0,1,249,249,0.42857
480,0,1,1,1,442,442,0.57143
0,65,0,0,4,31,-34,0
0,39,0,0,3,14,-25,0.14286
240,49,0,0,4,262,213,0
840,14,0,0,1,840,826,0.42857
480,75,0,0,4,498,423,0
0,0,1,1,2,-38,-38,0.71429
840,43,0,0,2,879,836,0.28571
240,0,1,1,3,256,256,0.85714
480,-28,0,0,1,480,508,0.42857
0,0,1,1,2,-24,-24,0.71429
840,0,1,0,1,854,854,0.42857
480,43,0,0,1,503,460,0.42857
480,0,1,1,2,469,469,0.71429
480,65,0,0,3,485,420,0.14286
480,29,0,0,2,488,459,0.28571
480,-2,0,0,1,471,473,0.42857
840,21,0,0,1,853,832,0.42857
480,-61,0,0,1,441,502,0.42857
240,0,1,1,2,261,261,0.71429
0,0,1,0,1,4,4,0.42857
480,93,0,0,4,533,440,0
480,10,0,0,2,476,466,0.28571
480,-1,0,1,2,487,488,0.71429
840,26,0,0,1,850,824,0.42857
0,25,0,0,4,11,-14,0
0,0,1,0,4,29,29,0
0,0,1,1,2,-16,-16,0.71429
840,0,1,1,3,814,814,0.85714
480,28,0,0,3,471,443,0.14286
240,22,0,0,2,253,231,0.28571
0,0,1,0,1,-33,-33,0.42857
480,14,0,1,1,482,468,0.57143
240,0,1,1,1,246,246,0.57143
0,0,1,1,1,10,10,0.57143
480,0,1,1,2,490,490,0.71429
480,41,0,0,3,513,472,0.14286
840,0,1,1,2,844,844,0.71429
840,-43,0,0,2,827,870,0.28571
840,-71,0,0,4,813,884,0
0,0,1,1,4,29,29,1
0,23,0,0,4,13,-10,0
840,0,1,0,1,848,848,0.42857
840,-29,0,0,2,822,851,0.28571
240,0,1,1,2,254,254,0.71429
0,0,1,1,2,-7,-7,0.71429
240,0,1,0,1,242,242,0.42857
480,0,1,1,2,489,489,0.71429
240,0,1,1,3,251,251,0.85714
480,17,0,1,3,479,462,0.85714
0,0,1,1,3,-1,-1,0.85714
0,0,1,1,3,-18,-18,0.85714
480,0,1,1,3,455,455,0.85714
0,35,0,0,4,-1,-36,0
0,0,1,0,1,37,37,0.42857
0,-5,0,1,3,-18,-13,0.85714
840,0,1,1,2,856,856,0.71429
480,0,1,1,2,463,463,0.71429
0,0,1,1,3,-38,-38,0.85714
0,0,1,0,1,-11,-11,0.42857
0,0,1,0,1,-15,-15,0.42857
240,35,0,0,4,234,199,0
0,19,0,0,2,45,26,0.28571
240,30,0,0,3,250,220,0.14286
240,-4,0,1,1,245,249,0.57143
0,0,1,1,1,57,57,0.57143
0,10,0,0,2,-4,-14,0.28571
0,0,1,0,1,-17,-17,0.42857
240,-8,0,1,3,223,231,0.85714
480,-36,0,0,3,485,521,0.14286
840,15,0,0,2,869,854,0.28571
480,0,1,1,1,480,480,0.57143
0,-25,0,0,3,-9,16,0.14286
480,20,0,1,1,517,497,0.57143
840,51,0,1,1,873,822,0.57143
240,0,1,1,1,232,232,0.57143
0,0,1,1,3,4,4,0.85714
240,0,1,1,3,294,294,0.85714
480,2,0,1,3,525,523,0.85714
0,62,0,0,4,10,-52,0
240,-35,0,0,3,233,268,0.14286
240,0,1,1,1,249,249,0.57143
840,0,1,1,1,895,895,0.57143
480,3,0,1,2,460,457,0.71429
0,-24,0,0,4,-52,-28,0
0,-41,0,0,3,0,41,0.14286
0,0,1,0,1,16,16,0.42857
480,0,1,1,1,476,476,0.57143
0,0,1,1,1,-18,-18,0.57143
840,3,0,1,2,842,839,0.71429
840,-14,0,1,2,812,826,0.71429
480,0,1,1,2,452,452,0.71429
480,-47,0,0,2,445,492,0.28571
480,0,1,0,1,465,465,0.42857
840,19,0,0,1,845,826,0.42857
480,20,0,1,2,501,481,0.71429
0,-30,0,0,3,-23,7,0.14286
840,0,1,0,1,823,823,0.42857
480,0,1,0,1,491,491,0.42857
480,0,1,0,1,518,518,0.42857
0,0,1,1,1,-11,-11,0.57143
840,0,1,0,1,819,819,0.42857
840,-17,0,0,1,828,845,0.42857
240,0,1,1,2,273,273,0.71429
240,32,0,0,3,234,202,0.14286
480,0,1,1,2,504,504,0.71429
0,46,0,0,4,18,-28,0
0,17,0,0,2,23,6,0.28571
840,17,0,0,1,867,850,0.42857
840,2,0,0,1,828,826,0.42857
240,0,1,1,2,227,227,0.71429
240,-14,0,1,2,209,223,0.71429
0,0,1,1,2,21,21,0.71429
840,0,1,1,2,852,852,0.71429
840,0,1,0,1,881,881,0.42857
240,4,0,1,3,216,212,0.85714
0,0,1,1,4,-31,-31,1
240,-15,0,1,2,280,295,0.71429
840,-14,0,1,2,862,876,0.71429
240,21,0,0,1,267,246,0.42857
0,-6,0,1,3,-13,-7,0.85714
0,0,1,1,4,-6,-6,1
0,-24,0,0,3,25,49,0.14286
840,69,0,0,3,885,816,0.14286
480,-42,0,0,2,445,487,0.28571
240,0,1,0,1,242,242,0.42857
840,0,1,0,1,843,843,0.42857
840,-78,0,0,3,792,870,0.14286
480,0,1,1,2,431,431,0.71429
840,0,1,1,2,868,868,0.71429
840,0,1,0,2,827,827,0.28571
0,47,0,0,4,27,-20,0
240,0,1,0,1,229,229,0.42857
480,-26,0,0,1,472,498,0.42857
0,-65,0,0,3,-69,-4,0.14286
840,0,1,0,1,867,867,0.42857
0,0,1,0,1,15,15,0.42857
480,-49,0,0,2,477,526,0.28571
240,-29,0,0,3,236,265,0.14286
0,0,1,0,1,-25,-25,0.42857
0,0,1,1,3,-0,-0,0.85714
840,0,1,1,3,842,842,0.85714
840,-23,0,0,3,861,884,0.14286
0,56,0,0,4,38,-18,0
840,0,1,1,2,814,814,0.71429
0,-8,0,0,1,16,24,0.42857
0,-30,0,0,3,30,60,0.14286
0,-17,0,0,3,-21,-4,0.14286
840,-10,0,1,1,840,850,0.57143
480,0,1,0,1,516,516,0.42857
0,11,0,0,3,26,15,0.14286
840,-21,0,0,1,821,842,0.42857
480,0,1,1,1,447,447,0.57143
840,0,1,1,2,855,855,0.71429
840,0,1,1,2,861,861,0.71429
840,-49,0,0,2,799,848,0.28571
0,-39,0,0,3,-49,-10,0.14286
240,0,1,1,1,296,296,0.57143
840,65,0,1,3,887,822,0.85714
840,0,1,1,2,820,820,0.71429
240,0,1,1,2,216,216,0.71429
480,0,1,1,2,464,464,0.71429
840,14,0,0,3,865,851,0.14286
480,7,0,1,3,482,475,0.85714
240,23,0,1,2,242,219,0.71429
0,0,1,1,2,-3,-3,0.71429
840,-2,0,1,2,848,850,0.71429
240,0,1,1,2,264,264,0.71429
480,39,0,0,3,469,430,0.14286
840,0,1,1,2,897,897,0.71429
0,0,1,0,1,56,56,0.42857
480,0,1,0,1,474,474,0.42857
240,0,1,0,2,256,256,0.28571
240,0,1,0,1,216,216,0.42857
480,0,1,1,2,531,531,0.71429
840,0,1,1,3,794,794,0.85714
480,45,0,0,3,503,458,0.14286
240,-17,0,0,1,205,222,0.42857
480,0,1,1,2,494,494,0.71429
0,0,1,1,3,6,6,0.85714
480,20,0,0,3,490,470,0.14286
0,-63,0,0,3,-31,32,0.14286
0,0,1,0,4,12,12,0
480,0,1,1,2,480,480,0.71429
480,-26,0,0,2,472,498,0.28571
240,12,0,0,3,222,210,0.14286
0,-22,0,0,3,10,32,0.14286
480,46,0,0,3,492,446,0.14286
840,0,1,0,1,813,813,0.42857
240,72,0,0,4,285,213,0
480,11,0,0,1,506,495,0.42857
840,9,0,0,1,828,819,0.42857
240,-67,0,0,3,207,274,0.14286
240,31,0,0,3,244,213,0.14286
0,-51,0,0,4,-2,49,0
240,0,1,0,4,270,270,0
0,0,1,1,1,25,25,0.57143
840,0,1,1,2,823,823,0.71429
240,0,1,1,3,223,223,0.85714
240,31,0,0,4,244,213,0
240,73,0,0,4,285,212,0
480,-14,0,1,2,466,480,0.71429
840,30,0,0,1,879,849,0.42857
240,0,1,1,2,254,254,0.71429
480,29,0,0,3,507,478,0.14286
240,0,1,0,1,226,226,0.42857
480,14,0,1,2,449,435,0.71429
0,0,1,1,3,14,14,0.85714
480,0,1,1,2,485,485,0.71429
240,12,0,0,1,269,257,0.42857
480,-15,0,1,2,469,484,0.71429
840,1,0,1,2,832,831,0.71429
480,-6,0,1,1,483,489,0.57143
840,-12,0,1,2,839,851,0.71429
840,0,1,1,2,871,871,0.71429
240,0,1,1,2,253,253,0.71429
480,0,1,1,2,462,462,0.71429
0,0,1,1,3,-23,-23,0.85714
0,0,1,1,4,3,3,1
840,-23,0,1,3,827,850,0.85714
0,0,1,0,1,7,7,0.42857
240,1,0,1,2,229,228,0.71429
0,0,1,0,1,28,28,0.42857
0,0,1,1,3,36,36,0.85714
480,-33,0,0,3,487,520,0.14286
0,8,0,0,1,-1,-9,0.42857
240,31,0,0,3,257,226,0.14286
240,-2,0,0,2,267,269,0.28571
0,-43,0,0,4,-34,9,0
240,0,1,1,1,246,246,0.57143
480,-46,0,0,3,480,526,0.14286
240,0,1,0,1,246,246,0.42857
480,0,1,1,2,444,444,0.71429
840,-46,0,0,2,796,842,0.28571
480,0,1,0,2,479,479,0.28571
480,0,1,0,1,475,475,0.42857
240,0,1,0,1,223,223,0.42857
240,-26,0,0,1,234,260,0.42857
240,0,1,1,2,226,226,0.71429
840,52,0,0,3,837,785,0.14286
0,26,0,0,3,1,-25,0.14286
240,0,1,0,1,232,232,0.42857
480,-11,0,0,1,473,484,0.42857
840,0,1,1,1,829,829,0.57143
240,15,0,0,1,258,243,0.42857
480,-16,0,0,1,471,487,0.42857
240,0,1,1,2,261,261,0.71429
480,0,1,1,2,480,480,0.71429
0,0,1,1,3,-14,-14,0.85714
480,0,1,1,3,504,504,0.85714
240,3,0,1,3,218,215,0.85714
480,0,1,0,1,501,501,0.42857
840,0,1,1,2,831,831,0.71429
480,0,1,1,3,446,446,0.85714
0,0,1,1,4,24,24,1
480,0,1,1,4,476,476,1
840,-18,0,1,1,825,843,0.57143
240,24,0,0,3,239,215,0.14286
0,0,1,0,1,-7,-7,0.42857
480,-13,0,0,2,470,483,0.28571
480,-22,0,0,1,479,501,0.42857
0,0,1,0,1,-7,-7,0.42857
0,0,1,1,1,1,1,0.57143
480,0,1,1,2,473,473,0.71429
840,0,1,0,1,853,853,0.42857
840,64,0,0,3,883,819,0.14286
480,-42,0,0,2,463,505,0.28571
480,-58,0,0,2,440,498,0.28571
480,0,1,0,3,504,504,0.14286
840,0,1,0,2,870,870,0.28571
840,0,1,0,2,860,860,0.28571
480,0,1,1,1,497,497,0.57143
840,10,0,1,1,832,822,0.57143
480,-12,0,1,2,478,490,0.71429
240,0,1,1,2,237,237,0.71429
480,-8,0,1,2,480,488,0.71429
0,-5,0,1,2,-2,3,0.71429
240,0,1,1,2,289,289,0.71429
0,16,0,0,3,46,30,0.14286
480,103,0,0,3,525,422,0.14286
840,0,1,0,2,811,811,0.28571
840,9,0,0,2,860,851,0.28571
840,0,1,0,2,832,832,0.28571
480,28,0,1,1,449,421,0.57143
0,0,1,1,2,-8,-8,0.71429
240,23,0,0,3,255,232,0.14286
480,0,1,0,2,485,485,0.28571
0,0,1,0,2,10,10,0.28571
840,61,0,0,3,873,812,0.14286
480,0,1,0,3,482,482,0.14286
480,65,0,0,4,496,431,0
0,30,0,0,4,13,-17,0
840,0,1,0,1,818,818,0.42857
240,-43,0,0,3,224,267,0.14286
240,27,0,0,3,255,228,0.14286
480,0,1,0,1,469,469,0.42857
0,0,1,0,1,-38,-38,0.42857
0,0,1,1,1,38,38,0.57143
840,4,0,1,1,839,835,0.57143
0,0,1,1,1,41,41,0.57143
840,0,1,1,1,848,848,0.57143
240,-24,0,0,2,250,274,0.28571
240,0,1,1,1,226,226,0.57143
240,3,0,1,2,215,212,0.71429
0,0,1,1,2,10,10,0.71429
240,0,1,1,2,191,191,0.71429
480,0,1,1,2,473,473,0.71429
240,0,1,1,2,251,251,0.71429
0,0,1,1,3,6,6,0.85714
0,-25,0,0,4,-32,-7,0
240,0,1,1,2,243,243,0.71429
240,-41,0,0,3,207,248,0.14286
240,0,1,1,3,239,239,0.85714
240,-17,0,0,2,223,240,0.28571
840,-47,0,0,4,814,861,0
240,12,0,0,1,250,238,0.42857
240,0,1,1,2,209,209,0.71429
840,0,1,0,2,852,852,0.28571
240,0,1,1,1,234,234,0.57143
840,-14,0,1,1,834,848,0.57143
240,18,0,1,2,239,221,0.71429
480,-26,0,0,2,454,480,0.28571
840,-69,0,0,3,798,867,0.14286
840,0,1,1,1,792,792,0.57143
480,0,1,0,1,501,501,0.42857
240,0,1,0,1,246,246,0.42857
840,0,1,1,1,836,836,0.57143
480,15,0,1,1,480,465,0.57143
0,0,1,1,3,36,36,0.85714
240,0,1,1,1,244,244,0.57143
0,0,1,1,1,-16,-16,0.57143
840,-19,0,1,1,825,844,0.57143
480,19,0,0,1,489,470,0.42857
480,11,0,1,2,484,473,0.71429
240,-11,0,1,2,230,241,0.71429
840,0,1,1,1,833,833,0.57143
480,0,1,1,2,485,485,0.71429
480,0,1,1,2,511,511,0.71429
480,-2,0,1,2,485,487,0.71429
480,0,1,1,1,445,445,0.57143
0,-17,0,0,3,2,19,0.14286
840,6,0,1,1,830,824,0.57143
840,-11,0,1,1,836,847,0.57143
480,4,0,1,2,499,495,0.71429
480,0,1,1,2,494,494,0.71429
0,10,0,0,2,1,-9,0.28571
240,0,1,0,1,243,243,0.42857
480,-30,0,0,3,439,469,0.14286
0,0,1,1,1,8,8,0.57143
840,29,0,1,1,876,847,0.57143
840,-10,0,1,2,834,844,0.71429
240,0,1,1,2,246,246,0.71429
480,29,0,0,3,480,451,0.14286
240,38,0,0,3,283,245,0.14286
0,-11,0,0,3,-21,-10,0.14286
840,-5,0,1,1,832,837,0.57143
240,0,1,1,2,269,269,0.71429
0,0,1,0,1,15,15,0.42857
240,27,0,0,3,267,240,0.14286
240,-30,0,0,4,188,218,0
480,11,0,0,1,470,459,0.42857
240,0,1,1,1,234,234,0.57143
480,-23,0,1,2,497,520,0.71429
840,0,1,1,1,866,866,0.57143
480,0,1,1,1,468,468,0.57143
0,2,0,0,3,10,8,0.14286
840,0,1,0,1,833,833,0.42857
0,0,1,1,2,20,20,0.71429
480,0,1,1,2,466,466,0.71429
240,15,0,0,2,230,215,0.28571
240,8,0,1,1,201,193,0.57143
240,-3,0,1,1,253,256,0.57143
0,0,1,1,1,-18,-18,0.57143
240,0,1,1,1,246,246,0.57143
840,0,1,1,1,858,858,0.57143
0,0,1,1,2,-39,-39,0.71429
480,-57,0,0,3,433,490,0.14286
240,-7,0,1,2,259,266,0.71429
840,0,1,1,2,829,829,0.71429
240,22,0,0,2,242,220,0.28571
480,11,0,1,1,454,443,0.57143
480,-50,0,0,3,472,522,0.14286
480,0,1,0,2,466,466,0.28571
0,30,0,0,3,9,-21,0.14286
840,-6,0,1,1,857,863,0.57143
0,0,1,0,2,-4,-4,0.28571
240,10,0,1,2,239,229,0.71429
840,0,1,1,2,819,819,0.71429
840,43,0,0,2,865,822,0.28571
840,0,1,0,2,859,859,0.28571
480,38,0,0,3,499,461,0.14286
840,0,1,0,1,828,828,0.42857
240,0,1,1,1,244,244,0.57143
840,0,1,1,1,883,883,0.57143
840,0,1,1,1,827,827,0.57143
480,8,0,1,2,501,493,0.71429
240,0,1,1,2,269,269,0.71429
840,17,0,0,1,864,847,0.42857
0,0,1,1,1,13,13,0.57143
840,0,1,0,2,845,845,0.28571
480,-4,0,1,1,493,497,0.57143
480,0,1,1,1,493,493,0.57143
0,-4,0,0,1,-10,-6,0.42857
240,0,1,1,1,247,247,0.57143
0,-14,0,0,3,-3,11,0.14286
240,-9,0,1,1,218,227,0.57143
840,0,1,1,1,867,867,0.57143
840,0,1,1,1,843,843,0.57143
840,0,1,1,1,833,833,0.57143
240,47,0,0,2,245,198,0.28571
480,0,1,1,2,455,455,0.71429
0,-25,0,0,3,13,38,0.14286
0,0,1,0,1,-20,-20,0.42857
480,-21,0,0,2,473,494,0.28571
480,0,1,1,1,495,495,0.57143
480,59,0,0,3,546,487,0.14286
240,0,1,1,1,225,225,0.57143
480,-37,0,0,1,452,489,0.42857
480,0,1,1,2,470,470,0.71429
0,-32,0,0,4,-38,-6,0
480,0,1,1,1,492,492,0.57143
240,-20,0,0,3,277,297,0.14286
240,0,1,1,1,268,268,0.57143
0,0,1,1,3,16,16,0.85714
240,-55,0,0,4,231,286,0
840,0,1,1,1,835,835,0.57143
840,-35,0,0,2,812,847,0.28571
840,0,1,1,1,847,847,0.57143
240,0,1,1,2,226,226,0.71429
240,-25,0,0,2,212,237,0.28571
840,3,0,1,1,808,805,0.57143
240,0,1,1,3,217,217,0.85714
840,0,1,1,1,834,834,0.57143
240,14,0,0,1,224,210,0.42857
240,9,0,1,1,253,244,0.57143
0,14,0,0,2,3,-11,0.28571
480,0,1,1,1,461,461,0.57143
240,0,1,1,2,266,266,0.71429
840,0,1,1,1,811,811,0.57143
480,0,1,1,1,496,496,0.57143
0,21,0,0,3,-2,-23,0.14286
840,0,1,1,2,805,805,0.71429
480,0,1,1,1,461,461,0.57143
0,0,1,1,2,14,14,0.71429
0,39,0,0,3,0,-39,0.14286
480,0,1,0,1,514,514,0.42857
0,30,0,0,3,-14,-44,0.14286
0,50,0,0,4,10,-40,0
0,0,1,1,1,34,34,0.57143
240,0,1,1,3,228,228,0.85714
840,50,0,0,4,866,816,0
840,16,0,0,1,861,845,0.42857
240,87,0,0,3,287,200,0.14286
0,0,1,1,1,-19,-19,0.57143
0,30,0,0,4,46,16,0
480,5,0,0,1,487,482,0.42857
840,0,1,1,1,843,843,0.57143
0,27,0,0,4,-9,-36,0
0,17,0,0,3,-4,-21,0.14286
240,0,1,0,1,249,249,0.42857
480,0,1,1,1,532,532,0.57143
0,0,1,0,3,16,16,0.14286
0,0,1,0,1,8,8,0.42857
480,12,0,1,1,470,458,0.57143
480,0,1,1,1,491,491,0.57143
480,0,1,1,1,470,470,0.57143
480,-10,0,1,2,446,456,0.71429
840,-8,0,1,2,828,836,0.71429
0,-14,0,0,3,25,39,0.14286
0,16,0,0,1,-5,-21,0.42857
840,22,0,1,3,873,851,0.85714
480,33,0,0,1,481,448,0.42857
240,-12,0,0,1,250,262,0.42857
240,0,1,0,1,243,243,0.42857
0,0,1,1,2,0,0,0.71429
480,0,1,0,1,476,476,0.42857
240,0,1,0,1,214,214,0.42857
0,0,1,1,3,5,5,0.85714
840,0,1,1,2,818,818,0.71429
0,-67,0,0,4,-21,46,0
480,-18,0,1,2,456,474,0.71429
240,0,1,1,2,241,241,0.71429
240,0,1,1,2,241,241,0.71429
480,71,0,0,4,473,402,0
840,0,1,1,1,828,828,0.57143
480,-22,0,1,1,477,499,0.57143
0,-33,0,1,3,-23,10,0.85714
480,0,1,1,3,490,490,0.85714
0,-8,0,0,1,1,9,0.42857
480,16,0,0,1,509,493,0.42857
840,-7,0,1,1,806,813,0.57143
480,20,0,1,2,485,465,0.71429
840,4,0,1,2,926,922,0.71429
480,0,1,1,2,471,471,0.71429
240,0,1,1,2,260,260,0.71429
480,-39,0,0,3,427,466,0.14286
0,0,1,1,2,12,12,0.71429
840,-25,0,0,2,826,851,0.28571
840,0,1,0,1,798,798,0.42857
240,0,1,1,3,260,260,0.85714
240,0,1,1,3,283,283,0.85714
0,18,0,0,3,-19,-37,0.14286
480,0,1,1,1,484,484,0.57143
0,0,1,1,2,10,10,0.71429
840,0,1,1,1,828,828,0.57143
840,0,1,1,1,851,851,0.57143
240,0,1,1,1,311,311,0.57143
240,-50,0,0,3,217,267,0.14286
0,0,1,1,2,-11,-11,0.71429
480,-20,0,0,3,455,475,0.14286
480,17,0,1,1,490,473,0.57143
0,22,0,1,3,15,-7,0.85714
480,0,1,1,3,493,493,0.85714
840,0,1,0,1,837,837,0.42857
840,0,1,1,3,821,821,0.85714
840,0,1,1,2,832,832,0.71429
0,-7,0,0,3,0,7,0.14286
840,0,1,1,2,806,806,0.71429
240,-45,0,0,3,226,271,0.14286
840,0,1,0,1,807,807,0.42857
840,-38,0,0,2,831,869,0.28571
480,-47,0,0,3,465,512,0.14286
0,0,1,0,2,0,0,0.28571
0,0,1,1,3,4,4,0.85714
240,0,1,1,1,230,230,0.57143
240,-68,0,0,2,178,246,0.28571
840,22,0,1,1,855,833,0.57143
0,0,1,1,2,-7,-7,0.71429
480,0,1,1,2,482,482,0.71429
840,0,1,0,1,805,805,0.42857
480,35,0,0,2,513,478,0.28571
480,0,1,0,2,466,466,0.28571
0,0,1,1,2,33,33,0.71429
840,16,0,1,1,834,818,0.57143
0,36,0,0,3,13,-23,0.14286
840,0,1,0,1,822,822,0.42857
0,0,1,1,3,-4,-4,0.85714
840,0,1,1,1,846,846,0.57143
0,0,1,1,2,21,21,0.71429
0,-31,0,0,2,15,46,0.28571
840,-51,0,0,3,816,867,0.14286
480,0,1,0,1,515,515,0.42857
480,26,0,0,2,486,460,0.28571
240,-18,0,0,1,223,241,0.42857
480,0,1,1,2,492,492,0.71429
0,1,0,0,2,29,28,0.28571
840,0,1,0,1,835,835,0.42857
240,19,0,0,2,261,242,0.28571
480,0,1,1,2,475,475,0.71429
840,30,0,0,2,865,835,0.28571
840,-23,0,1,1,839,862,0.57143
0,-10,0,1,2,-19,-9,0.71429
0,-89,0,0,3,-49,40,0.14286
0,-7,0,1,1,-20,-13,0.57143
840,-51,0,0,2,782,833,0.28571
840,0,1,1,3,850,850,0.85714
480,0,1,0,1,482,482,0.42857
240,32,0,0,3,261,229,0.14286
480,0,1,0,1,452,452,0.42857
0,0,1,1,3,-11,-11,0.85714
240,10,0,0,1,233,223,0.42857
480,0,1,1,1,514,514,0.57143
480,0,1,1,1,468,468,0.57143
0,-34,0,0,3,4,38,0.14286
840,3,0,1,2,865,862,0.71429
0,0,1,1,2,-31,-31,0.71429
840,28,0,1,2,845,817,0.71429
0,0,1,1,2,-35,-35,0.71429
240,0,1,1,3,229,229,0.85714
240,-17,0,0,1,246,263,0.42857
840,0,1,0,1,859,859,0.42857
240,0,1,1,2,224,224,0.71429
480,0,1,1,1,494,494,0.57143
840,1,0,1,1,823,822,0.57143
0,41,0,0,3,13,-28,0.14286
240,-68,0,0,3,223,291,0.14286
0,0,1,1,2,-27,-27,0.71429
0,0,1,1,2,22,22,0.71429
840,19,0,0,1,884,865,0.42857
840,19,0,0,1,891,872,0.42857
0,0,1,1,3,9,9,0.85714
240,-31,0,0,1,217,248,0.42857
480,64,0,0,3,500,436,0.14286
480,0,1,0,1,477,477,0.42857
240,26,0,0,1,260,234,0.42857
240,-27,0,0,1,235,262,0.42857
840,-27,0,0,1,838,865,0.42857
480,22,0,1,2,452,430,0.71429
0,-24,0,0,2,-46,-22,0.28571
0,0,1,0,1,-30,-30,0.42857
480,37,0,0,2,497,460,0.28571
840,0,1,1,1,844,844,0.57143
240,-7,0,1,3,214,221,0.85714
480,-13,0,1,2,473,486,0.71429
240,42,0,0,3,274,232,0.14286
840,0,1,1,2,852,852,0.71429
240,0,1,1,2,242,242,0.71429
480,11,0,1,2,546,535,0.71429
480,0,1,1,2,516,516,0.71429
0,-2,0,1,3,-12,-10,0.85714
0,0,1,1,4,8,8,1
840,0,1,1,2,872,872,0.71429
0,24,0,0,3,42,18,0.14286
0,0,1,0,2,-8,-8,0.28571
840,0,1,1,2,856,856,0.71429
480,-63,0,0,3,457,520,0.14286
480,0,1,1,2,455,455,0.71429
240,-4,0,1,2,241,245,0.71429
240,64,0,0,3,251,187,0.14286
240,-66,0,0,3,205,271,0.14286
240,0,1,0,2,248,248,0.28571
480,0,1,0,2,467,467,0.28571
480,0,1,1,2,490,490,0.71429
240,0,1,1,2,270,270,0.71429
840,26,0,0,1,852,826,0.42857
240,0,1,1,2,221,221,0.71429
840,0,1,1,3,811,811,0.85714
480,22,0,0,1,490,468,0.42857
240,10,0,1,2,252,242,0.71429
840,-5,0,1,2,888,893,0.71429
480,12,0,1,2,465,453,0.71429
0,13,0,0,3,19,6,0.14286
840,33,0,1,2,839,806,0.71429
480,0,1,1,2,504,504,0.71429
840,-1,0,1,3,839,840,0.85714
480,-19,0,1,2,438,457,0.71429
0,-42,0,0,3,-30,12,0.14286
240,0,1,1,3,223,223,0.85714
840,-12,0,1,2,844,856,0.71429
240,16,0,0,2,244,228,0.28571
240,0,1,0,1,259,259,0.42857
240,0,1,1,1,251,251,0.57143
240,0,1,1,2,231,231,0.71429
840,0,1,1,3,814,814,0.85714
840,16,0,1,2,801,785,0.71429
480,-2,0,1,2,473,475,0.71429
480,-7,0,1,2,454,461,0.71429
240,0,1,1,2,217,217,0.71429
840,0,1,1,2,838,838,0.71429
240,-8,0,1,1,247,255,0.57143
480,0,1,1,1,511,511,0.57143
0,0,1,1,2,7,7,0.71429
0,0,1,1,2,-10,-10,0.71429
480,0,1,1,2,521,521,0.71429
240,53,0,0,3,274,221,0.14286
840,0,1,0,1,836,836,0.42857
480,0,1,1,2,479,479,0.71429
240,0,1,1,2,263,263,0.71429
0,10,0,0,3,19,9,0.14286
480,0,1,0,1,499,499,0.42857
480,-41,0,0,3,452,493,0.14286
0,0,1,0,1,30,30,0.42857
240,0,1,1,2,230,230,0.71429
0,0,1,1,2,-36,-36,0.71429
480,-84,0,0,3,433,517,0.14286
840,0,1,1,1,819,819,0.57143
480,45,0,0,3,481,436,0.14286
480,-37,0,0,2,437,474,0.28571
480,0,1,0,1,499,499,0.42857
840,0,1,1,1,831,831,0.57143
840,0,1,1,1,814,814,0.57143
240,-53,0,0,3,216,269,0.14286
480,0,1,1,1,482,482,0.57143
480,0,1,1,1,472,472,0.57143
480,6,0,1,2,498,492,0.71429
840,28,0,0,2,853,825,0.28571
480,-27,0,0,1,466,493,0.42857
0,0,1,1,3,14,14,0.85714
240,-20,0,1,1,247,267,0.57143
240,-7,0,1,2,233,240,0.71429
480,1,0,1,1,490,489,0.57143
240,0,1,1,1,253,253,0.57143
0,14,0,0,3,28,14,0.14286
240,0,1,1,2,239,239,0.71429
0,0,1,0,1,63,63,0.42857
240,0,1,1,2,306,306,0.71429
240,0,1,1,2,232,232,0.71429
480,0,1,1,2,488,488,0.71429
840,0,1,1,1,849,849,0.57143
0,0,1,1,3,3,3,0.85714
240,0,1,1,2,222,222,0.71429
480,0,1,1,2,466,466,0.71429
480,56,0,0,3,512,456,0.14286
840,-18,0,0,3,808,826,0.14286
240,0,1,0,1,208,208,0.42857
480,0,1,1,2,480,480,0.71429
480,0,1,1,2,481,481,0.71429
0,0,1,0,1,-31,-31,0.42857
0,0,1,0,2,39,39,0.28571
0,-10,0,0,1,29,39,0.42857
0,0,1,1,2,-34,-34,0.71429
240,0,1,1,2,255,255,0.71429
240,-6,0,0,1,223,229,0.42857
480,0,1,0,1,484,484,0.42857
480,0,1,1,2,516,516,0.71429
0,22,0,0,3,4,-18,0.14286
840,55,0,0,4,887,832,0
240,9,0,1,2,235,226,0.71429
0,-37,0,0,4,-21,16,0
240,0,1,1,1,231,231,0.57143
480,-11,0,0,1,450,461,0.42857
480,0,1,1,2,458,458,0.71429
240,0,1,1,2,242,242,0.71429
240,0,1,0,1,202,202,0.42857
240,0,1,1,2,246,246,0.71429
240,-4,0,0,1,261,265,0.42857
0,0,1,1,3,12,12,0.85714
480,0,1,1,3,480,480,0.85714
840,0,1,1,3,874,874,0.85714
0,0,1,1,3,3,3,0.85714
0,-26,0,0,3,-18,8,0.14286
480,-44,0,0,2,452,496,0.28571
840,20,0,1,2,882,862,0.71429
840,0,1,1,2,835,835,0.71429
840,0,1,1,2,843,843,0.71429
840,-11,0,1,2,832,843,0.71429
480,36,0,0,1,525,489,0.42857
480,-67,0,0,3,447,514,0.14286
240,0,1,1,2,267,267,0.71429
240,0,1,1,2,260,260,0.71429
840,0,1,1,1,840,840,0.57143
0,0,1,1,3,-17,-17,0.85714
0,0,1,1,3,-6,-6,0.85714
840,0,1,1,1,851,851,0.57143
240,22,0,0,3,250,228,0.14286
840,17,0,0,1,865,848,0.42857
240,-5,0,1,2,228,233,0.71429
0,16,0,0,1,-23,-39,0.42857
840,0,1,1,3,882,882,0.85714
480,48,0,0,3,497,449,0.14286
0,0,1,1,3,16,16,0.85714
840,0,1,0,1,854,854,0.42857
0,0,1,1,3,-19,-19,0.85714
480,0,1,0,1,441,441,0.42857
240,0,1,1,1,184,184,0.57143
0,0,1,1,2,57,57,0.71429
840,0,1,1,1,803,803,0.57143
0,3,0,1,3,-4,-7,0.85714
240,-17,0,1,2,191,208,0.71429
0,-25,0,0,3,-21,4,0.14286
0,36,0,0,3,17,-19,0.14286
0,-15,0,0,1,-24,-9,0.42857
0,-11,0,0,1,-30,-19,0.42857
240,9,0,0,1,222,213,0.42857
240,0,1,1,2,290,290,0.71429
480,14,0,0,1,529,515,0.42857
0,-37,0,0,3,-14,23,0.14286
240,23,0,0,1,242,219,0.42857
0,22,0,0,3,-9,-31,0.14286
240,0,1,1,2,232,232,0.71429
480,2,0,1,2,470,468,0.71429
840,0,1,1,1,832,832,0.57143
0,0,1,1,3,-16,-16,0.85714
240,0,1,1,2,236,236,0.71429
480,69,0,0,3,537,468,0.14286
240,0,1,1,1,231,231,0.57143
480,0,1,1,1,502,502,0.57143
840,35,0,0,2,834,799,0.28571
840,12,0,0,1,873,861,0.42857
240,4,0,1,2,238,234,0.71429
0,14,0,0,3,48,34,0.14286
840,18,0,0,1,851,833,0.42857
240,0,1,1,3,214,214,0.85714
0,0,1,1,2,55,55,0.71429
240,56,0,0,3,244,188,0.14286
240,0,1,0,2,278,278,0.28571
0,17,0,0,2,15,-2,0.28571
240,-30,0,0,3,239,269,0.14286
480,0,1,0,1,479,479,0.42857
840,51,0,0,3,884,833,0.14286
240,-9,0,0,2,224,233,0.28571
0,-3,0,0,1,-14,-11,0.42857
480,1,0,1,3,475,474,0.85714
0,0,1,1,1,-23,-23,0.57143
240,0,1,1,2,225,225,0.71429
840,21,0,1,2,863,842,0.71429
840,-21,0,0,1,845,866,0.42857
480,0,1,0,1,456,456,0.42857
0,68,0,0,3,20,-48,0.14286
240,-14,0,0,2,223,237,0.28571
240,0,1,1,2,251,251,0.71429
840,0,1,1,2,817,817,0.71429
480,-1,0,1,2,511,512,0.71429
840,-10,0,1,2,840,850,0.71429
240,13,0,1,3,219,206,0.85714
0,0,1,1,4,12,12,1
840,0,1,1,1,841,841,0.57143
0,0,1,1,2,-44,-44,0.71429
240,52,0,0,4,259,207,0
0,0,1,1,1,-13,-13,0.57143
840,-5,0,1,1,830,835,0.57143
0,51,0,0,4,28,-23,0
0,0,1,1,1,-26,-26,0.57143
840,18,0,0,1,862,844,0.42857
480,9,0,1,2,484,475,0.71429
0,47,0,0,3,48,1,0.14286
480,9,0,0,4,478,469,0
240,-15,0,0,1,218,233,0.42857
480,0,1,1,2,458,458,0.71429
0,15,0,0,2,13,-2,0.28571
840,39,0,1,1,840,801,0.57143
0,17,0,0,1,-29,-46,0.42857
0,-14,0,0,2,1,15,0.28571
0,0,1,0,2,64,64,0.28571
0,0,1,0,2,-14,-14,0.28571
240,0,1,1,2,259,259,0.71429
480,0,1,1,2,490,490,0.71429
840,0,1,1,1,869,869,0.57143
0,-10,0,0,3,1,11,0.14286
840,-2,0,1,1,853,855,0.57143
840,-57,0,0,1,815,872,0.42857
0,2,0,0,1,12,10,0.42857
0,-22,0,0,1,-16,6,0.42857
240,-12,0,0,1,238,250,0.42857
240,-5,0,0,2,226,231,0.28571
480,0,1,1,2,457,457,0.71429
480,3,0,1,1,468,465,0.57143
240,0,1,1,2,252,252,0.71429
480,0,1,1,1,451,451,0.57143
480,-32,0,0,1,479,511,0.42857
240,14,0,0,1,239,225,0.42857
480,0,1,0,1,485,485,0.42857
240,0,1,1,2,226,226,0.71429
840,7,0,1,2,818,811,0.71429
240,35,0,0,2,291,256,0.28571
0,0,1,1,2,38,38,0.71429
480,0,1,1,2,511,511,0.71429
0,0,1,1,1,20,20,0.57143
480,0,1,1,1,490,490,0.57143
240,0,1,1,2,260,260,0.71429
0,-16,0,0,3,-20,-4,0.14286
480,0,1,1,1,473,473,0.57143
480,-51,0,0,3,487,538,0.14286
240,0,1,1,2,257,257,0.71429
480,-22,0,1,1,489,511,0.57143
480,0,1,1,1,470,470,0.57143
840,-56,0,0,2,780,836,0.28571
0,0,1,1,2,44,44,0.71429
840,93,0,0,3,901,808,0.14286
0,0,1,0,2,20,20,0.28571
840,-24,0,0,1,832,856,0.42857
840,0,1,1,2,860,860,0.71429
480,-6,0,1,2,468,474,0.71429
240,0,1,1,2,218,218,0.71429
840,0,1,1,2,766,766,0.71429
240,-16,0,1,2,234,250,0.71429
240,12,0,0,1,262,250,0.42857
480,-11,0,1,2,460,471,0.71429
0,19,0,0,3,11,-8,0.14286
840,0,1,1,2,832,832,0.71429
840,-59,0,1,1,827,886,0.57143
240,0,1,1,2,233,233,0.71429
480,36,0,0,3,502,466,0.14286
840,0,1,0,1,818,818,0.42857
0,-28,0,0,3,-18,10,0.14286
840,-30,0,0,2,855,885,0.28571
240,0,1,1,2,248,248,0.71429
480,-2,0,1,2,477,479,0.71429
840,38,0,1,1,858,820,0.57143
480,44,0,1,1,508,464,0.57143
840,0,1,1,1,803,803,0.57143
840,-49,0,1,1,804,853,0.57143
480,3,0,1,1,484,481,0.57143
0,88,0,0,4,85,-3,0
240,0,1,1,1,186,186,0.57143
840,31,0,0,1,853,822,0.42857
240,0,1,1,1,258,258,0.57143
480,-17,0,0,1,486,503,0.42857
840,-27,0,0,2,823,850,0.28571
840,27,0,0,1,848,821,0.42857
240,0,1,1,2,268,268,0.71429
240,-37,0,0,2,194,231,0.28571
840,-50,0,0,1,809,859,0.42857
240,0,1,1,2,231,231,0.71429
240,0,1,1,2,225,225,0.71429
0,-6,0,0,1,12,18,0.42857
840,-2,0,1,1,857,859,0.57143
0,13,0,0,3,7,-6,0.14286
0,-43,0,0,4,-18,25,0
480,-26,0,0,1,483,509,0.42857
480,0,1,1,2,484,484,0.71429
840,0,1,1,2,841,841,0.71429
480,-37,0,0,2,446,483,0.28571
840,0,1,0,1,838,838,0.42857
840,0,1,1,2,863,863,0.71429
840,-32,0,1,2,803,835,0.71429
480,-51,0,1,3,434,485,0.85714
840,0,1,1,2,846,846,0.71429
240,50,0,0,4,303,253,0
240,0,1,1,1,278,278,0.57143
240,30,0,0,2,255,225,0.28571
840,0,1,1,2,832,832,0.71429
240,0,1,0,1,235,235,0.42857
480,0,1,0,1,497,497,0.42857
0,-2,0,1,2,2,4,0.71429
240,0,1,1,2,253,253,0.71429
480,20,0,0,2,505,485,0.28571
0,0,1,1,1,17,17,0.57143
840,30,0,0,2,872,842,0.28571
840,0,1,1,1,826,826,0.57143
0,-14,0,0,2,-33,-19,0.28571
0,-36,0,0,3,-42,-6,0.14286
0,0,1,1,3,3,3,0.85714
240,24,0,0,1,277,253,0.42857
0,0,1,1,2,4,4,0.71429
840,0,1,0,1,865,865,0.42857
240,0,1,1,3,251,251,0.85714
840,0,1,1,2,907,907,0.71429
0,-25,0,0,3,-7,18,0.14286
840,-44,0,0,2,806,850,0.28571
480,-9,0,0,1,454,463,0.42857
240,0,1,0,1,216,216,0.42857
240,0,1,0,1,236,236,0.42857
240,0,1,0,1,204,204,0.42857
0,0,1,1,2,-4,-4,0.71429
240,37,0,0,4,238,201,0
840,0,1,0,2,837,837,0.28571
840,-26,0,1,2,805,831,0.71429
0,0,1,1,3,-33,-33,0.85714
0,26,0,0,4,40,14,0
0,0,1,0,1,10,10,0.42857
840,0,1,1,2,801,801,0.71429
0,0,1,0,1,-7,-7,0.42857
0,0,1,1,3,-28,-28,0.85714
840,0,1,1,1,813,813,0.57143
480,0,1,0,1,497,497,0.42857
0,0,1,1,3,-53,-53,0.85714
840,-51,0,0,1,808,859,0.42857
840,-13,0,1,2,842,855,0.71429
840,-44,0,1,1,812,856,0.57143
240,0,1,1,1,243,243,0.57143
0,0,1,1,2,13,13,0.71429
480,2,0,1,1,471,469,0.57143
0,-12,0,0,2,-6,6,0.28571
480,-24,0,0,2,472,496,0.28571
0,13,0,0,2,41,28,0.28571
840,0,1,1,1,841,841,0.57143
0,0,1,0,1,-26,-26,0.42857
240,6,0,1,1,249,243,0.57143
240,0,1,1,1,241,241,0.57143
840,-63,0,0,1,832,895,0.42857
840,0,1,0,2,887,887,0.28571
480,9,0,1,1,481,472,0.57143
240,18,0,1,1,244,226,0.57143
480,-23,0,1,1,477,500,0.57143
0,-36,0,0,3,-15,21,0.14286
480,-7,0,0,1,492,499,0.42857
240,-32,0,0,2,249,281,0.28571
240,0,1,0,1,209,209,0.42857
240,0,1,0,1,240,240,0.42857
0,0,1,0,1,-6,-6,0.42857
840,0,1,1,1,881,881,0.57143
240,0,1,1,1,246,246,0.57143
240,0,1,1,2,252,252,0.71429
240,38,0,0,3,256,218,0.14286
480,37,0,0,1,523,486,0.42857
0,0,1,1,2,-3,-3,0.71429
480,-24,0,1,1,435,459,0.57143
480,47,0,0,2,517,470,0.28571
0,0,1,1,1,-47,-47,0.57143
480,0,1,1,1,529,529,0.57143
480,0,1,1,1,484,484,0.57143
0,0,1,1,2,26,26,0.71429
240,40,0,0,2,255,215,0.28571
0,41,0,0,3,13,-28,0.14286
240,-1,0,1,1,269,270,0.57143
480,0,1,0,1,503,503,0.42857
0,0,1,1,2,-31,-31,0.71429
840,13,0,0,1,847,834,0.42857
840,-21,0,1,1,846,867,0.57143
0,0,1,0,1,17,17,0.42857
840,0,1,1,2,797,797,0.71429
240,-2,0,1,2,222,224,0.71429
840,0,1,1,1,830,830,0.57143
240,0,1,1,1,244,244,0.57143
240,-15,0,0,2,231,246,0.28571
0,4,0,0,1,17,13,0.42857
240,6,0,1,1,193,187,0.57143
240,0,1,1,1,210,210,0.57143
240,87,0,0,2,293,206,0.28571
480,5,0,0,1,501,496,0.42857
840,-13,0,1,1,831,844,0.57143
0,67,0,0,3,27,-40,0.14286
840,0,1,1,1,820,820,0.57143
240,10,0,1,2,233,223,0.71429
840,0,1,1,1,830,830,0.57143
240,-33,0,0,3,246,279,0.14286
480,0,1,0,1,500,500,0.42857
0,-49,0,0,3,-39,10,0.14286
240,0,1,1,1,223,223,0.57143
840,0,1,1,1,839,839,0.57143
480,-41,0,0,3,467,508,0.14286
480,19,0,0,2,486,467,0.28571
480,-20,0,0,1,498,518,0.42857
840,14,0,1,1,837,823,0.57143
0,0,1,1,1,2,2,0.57143
840,0,1,0,1,869,869,0.42857
240,0,1,1,1,235,235,0.57143
240,0,1,1,2,269,269,0.71429
840,39,0,1,2,861,822,0.71429
840,0,1,1,1,826,826,0.57143
840,0,1,1,1,804,804,0.57143
0,0,1,1,1,14,14,0.57143
480,4,0,1,1,479,475,0.57143
0,-15,0,1,1,-1,14,0.57143
840,0,1,1,2,890,890,0.71429
480,6,0,1,2,485,479,0.71429
240,0,1,1,2,280,280,0.71429
0,-26,0,0,3,-44,-18,0.14286
840,-32,0,0,3,818,850,0.14286
0,0,1,0,1,3,3,0.42857
480,0,1,1,2,474,474,0.71429
240,0,1,1,2,233,233,0.71429
480,0,1,1,2,463,463,0.71429
840,0,1,1,2,857,857,0.71429
240,-5,0,1,2,246,251,0.71429
240,3,0,0,1,246,243,0.42857
480,0,1,1,2,450,450,0.71429
0,0,1,1,2,55,55,0.71429
0,-3,0,1,2,-16,-13,0.71429
480,-9,0,1,2,482,491,0.71429
480,0,1,1,2,487,487,0.71429
0,0,1,1,2,-48,-48,0.71429
480,0,1,0,1,508,508,0.42857
840,0,1,1,1,850,850,0.57143
480,-12,0,0,1,478,490,0.42857
0,7,0,0,2,-7,-14,0.28571
240,0,1,1,2,220,220,0.71429
0,0,1,0,1,31,31,0.42857
840,0,1,1,1,819,819,0.57143
840,-14,0,1,1,811,825,0.57143
840,25,0,1,1,850,825,0.57143
240,0,1,1,1,264,264,0.57143
240,-6,0,1,1,235,241,0.57143
240,0,1,1,1,197,197,0.57143
840,0,1,1,2,846,846,0.71429
0,0,1,1,2,-13,-13,0.71429
840,-4,0,1,2,834,838,0.71429
840,32,0,1,2,862,830,0.71429
840,0,1,0,1,876,876,0.42857
840,48,0,0,2,891,843,0.28571
0,0,1,1,2,-28,-28,0.71429
240,0,1,1,2,258,258,0.71429
480,0,1,1,2,457,457,0.71429
840,-5,0,1,2,860,865,0.71429
480,0,1,0,2,507,507,0.28571
240,0,1,1,1,237,237,0.57143
480,0,1,1,1,467,467,0.57143
840,-5,0,1,1,858,863,0.57143
840,0,1,1,1,842,842,0.57143
840,-34,0,1,2,831,865,0.71429
480,0,1,1,2,501,501,0.71429
480,0,1,1,2,471,471,0.71429
480,0,1,1,2,484,484,0.71429
840,0,1,1,2,835,835,0.71429
840,0,1,1,2,856,856,0.71429
240,0,1,1,2,269,269,0.71429
0,22,0,0,3,8,-14,0.14286
0,-33,0,0,3,4,37,0.14286
840,0,1,0,2,839,839,0.28571
840,0,1,1,1,873,873,0.57143
480,12,0,1,2,480,468,0.71429
240,86,0,0,3,302,216,0.14286
0,-16,0,0,3,-48,-32,0.14286
480,0,1,1,2,519,519,0.71429
0,0,1,0,3,19,19,0.14286
840,0,1,1,2,856,856,0.71429
240,0,1,1,2,260,260,0.71429
840,0,1,1,2,879,879,0.71429
480,0,1,1,1,478,478,0.57143
480,0,1,1,1,482,482,0.57143
240,0,1,1,2,252,252,0.71429
840,0,1,1,1,826,826,0.57143
0,33,0,0,3,12,-21,0.14286
0,41,0,0,3,22,-19,0.14286
480,-57,0,0,2,480,537,0.28571
840,0,1,0,1,799,799,0.42857
240,-26,0,0,2,207,233,0.28571
480,-29,0,1,2,466,495,0.71429
0,0,1,1,2,-7,-7,0.71429
240,39,0,0,3,285,246,0.14286
0,-25,0,0,3,-28,-3,0.14286
240,-18,0,0,2,256,274,0.28571
240,-42,0,0,1,225,267,0.42857
480,0,1,1,1,526,526,0.57143
240,0,1,1,1,286,286,0.57143
0,24,0,0,3,-22,-46,0.14286
840,16,0,0,2,836,820,0.28571
480,0,1,0,1,526,526,0.42857
240,-14,0,1,1,237,251,0.57143
0,0,1,1,2,21,21,0.71429
240,0,1,0,3,256,256,0.14286
0,-62,0,0,3,-29,33,0.14286
0,0,1,0,2,-12,-12,0.28571
480,-49,0,0,1,431,480,0.42857
480,-19,0,0,1,502,521,0.42857
840,14,0,1,1,836,822,0.57143
480,0,1,1,2,448,448,0.71429
840,0,1,1,1,842,842,0.57143
0,0,1,1,1,-18,-18,0.57143
840,0,1,1,2,897,897,0.71429
480,-16,0,1,2,490,506,0.71429
0,0,1,0,2,8,8,0.28571
0,0,1,0,2,21,21,0.28571
840,-29,0,1,1,821,850,0.57143
840,-24,0,1,1,858,882,0.57143
0,30,0,0,3,10,-20,0.14286
840,-5,0,1,2,849,854,0.71429
0,-9,0,0,2,1,10,0.28571
0,0,1,1,2,-29,-29,0.71429
480,0,1,1,2,511,511,0.71429
240,19,0,0,3,267,248,0.14286
0,0,1,1,1,-18,-18,0.57143
840,-16,0,1,1,840,856,0.57143
840,4,0,1,2,823,819,0.71429
480,28,0,0,3,510,482,0.14286
840,20,0,0,2,832,812,0.28571
840,0,1,0,2,809,809,0.28571
840,16,0,0,2,824,808,0.28571
840,65,0,0,1,867,802,0.42857
0,0,1,0,1,11,11,0.42857
840,-11,0,0,1,816,827,0.42857
480,0,1,0,2,479,479,0.28571
0,0,1,1,1,-41,-41,0.57143
240,14,0,0,2,245,231,0.28571
0,34,0,1,2,21,-13,0.71429
480,21,0,1,2,473,452,0.71429
840,27,0,1,1,833,806,0.57143
0,0,1,1,1,23,23,0.57143
840,73,0,1,2,861,788,0.71429
0,2,0,1,1,-9,-11,0.57143
480,-2,0,1,1,493,495,0.57143
0,0,1,1,2,-2,-2,0.71429
240,-10,0,1,2,247,257,0.71429
480,0,1,1,2,467,467,0.71429
840,-33,0,1,1,819,852,0.57143
240,0,1,1,1,222,222,0.57143
480,-17,0,1,2,491,508,0.71429
240,0,1,1,1,267,267,0.57143
840,32,0,1,1,840,808,0.57143
0,0,1,1,1,45,45,0.57143
840,23,0,1,1,860,837,0.57143
240,11,0,0,1,228,217,0.42857
840,48,0,1,2,831,783,0.71429
840,0,1,1,1,807,807,0.57143
240,0,1,1,1,245,245,0.57143
480,0,1,0,1,523,523,0.42857
240,-3,0,1,1,239,242,0.57143
840,-31,0,1,1,801,832,0.57143
240,0,1,1,2,267,267,0.71429
480,0,1,1,2,489,489,0.71429
0,0,1,1,1,29,29,0.57143
0,0,1,1,1,-27,-27,0.57143
840,16,0,1,1,866,850,0.57143
480,-27,0,1,2,463,490,0.71429
240,0,1,1,1,241,241,0.57143
840,0,1,1,1,824,824,0.57143
0,0,1,1,2,-35,-35,0.71429
480,23,0,0,1,490,467,0.42857
480,0,1,1,1,493,493,0.57143
840,-9,0,1,1,805,814,0.57143
240,0,1,1,1,228,228,0.57143
0,0,1,1,2,-41,-41,0.71429
840,-66,0,0,2,806,872,0.28571
0,0,1,1,1,-1,-1,0.57143
0,73,0,0,3,36,-37,0.14286
240,48,0,0,3,233,185,0.14286
240,-8,0,1,1,232,240,0.57143
840,7,0,1,1,842,835,0.57143
840,0,1,1,1,815,815,0.57143
480,40,0,0,2,507,467,0.28571
480,0,1,1,1,464,464,0.57143
240,3,0,1,1,226,223,0.57143
480,0,1,1,1,469,469,0.57143
840,2,0,1,1,866,864,0.57143
840,0,1,1,1,837,837,0.57143
840,0,1,1,1,846,846,0.57143
480,16,0,0,1,478,462,0.42857
0,-7,0,0,3,9,16,0.14286
0,-50,0,0,3,-33,17,0.14286
840,0,1,0,1,845,845,0.42857
0,0,1,0,2,-10,-10,0.28571
240,13,0,0,1,254,241,0.42857
0,-21,0,0,3,6,27,0.14286
480,-18,0,1,1,492,510,0.57143
840,13,0,0,1,854,841,0.42857
0,67,0,0,3,45,-22,0.14286
480,29,0,0,1,502,473,0.42857
0,0,1,0,2,15,15,0.28571
240,4,0,1,1,254,250,0.57143
840,39,0,0,2,893,854,0.28571
0,47,0,0,4,46,-1,0
240,0,1,0,1,213,213,0.42857
240,-24,0,0,3,219,243,0.14286
0,-11,0,0,3,-7,4,0.14286
0,0,1,1,1,37,37,0.57143
840,0,1,1,1,838,838,0.57143
240,0,1,0,3,240,240,0.14286
840,0,1,1,1,900,900,0.57143
480,0,1,1,1,446,446,0.57143
240,33,0,0,3,257,224,0.14286
0,0,1,0,1,-8,-8,0.42857
840,-30,0,0,1,815,845,0.42857
840,0,1,1,1,821,821,0.57143
0,0,1,1,1,20,20,0.57143
0,0,1,1,2,-0,-0,0.71429
240,0,1,1,2,273,273,0.71429
0,0,1,1,2,38,38,0.71429
840,0,1,1,2,836,836,0.71429
0,-49,0,0,3,-17,32,0.14286
480,0,1,1,2,525,525,0.71429
240,-66,0,0,3,231,297,0.14286
840,0,1,1,2,871,871,0.71429
0,36,0,0,4,40,4,0
240,10,0,0,1,241,231,0.42857
840,0,1,1,1,887,887,0.57143
840,0,1,1,1,868,868,0.57143
240,0,1,1,2,231,231,0.71429
0,0,1,0,1,30,30,0.42857
480,0,1,1,1,525,525,0.57143
240,0,1,1,1,210,210,0.57143
0,12,0,0,1,5,-7,0.42857
0,-4,0,1,1,-32,-28,0.57143
240,0,1,1,1,250,250,0.57143
0,0,1,0,1,22,22,0.42857
0,0,1,1,2,-69,-69,0.71429
480,0,1,1,1,498,498,0.57143
0,0,1,1,1,4,4,0.57143
840,-78,0,0,3,798,876,0.14286
240,35,0,0,2,264,229,0.28571
480,0,1,0,1,483,483,0.42857
240,0,1,1,1,228,228,0.57143
240,0,1,1,1,253,253,0.57143
480,-11,0,1,2,487,498,0.71429
240,0,1,1,2,209,209,0.71429
480,3,0,1,1,485,482,0.57143
240,-4,0,1,1,228,232,0.57143
480,-2,0,0,2,471,473,0.28571
480,0,1,1,1,509,509,0.57143
240,116,0,0,3,296,180,0.14286
0,0,1,1,2,8,8,0.71429
480,0,1,1,2,522,522,0.71429
480,-45,0,0,3,442,487,0.14286
240,0,1,1,1,229,229,0.57143
0,0,1,1,1,18,18,0.57143
480,61,0,0,3,517,456,0.14286
0,33,0,0,4,34,1,0
0,21,0,0,4,12,-9,0
240,-2,0,1,1,247,249,0.57143
240,-16,0,1,1,250,266,0.57143
840,0,1,1,1,854,854,0.57143
240,-8,0,1,2,257,265,0.71429
240,21,0,0,3,260,239,0.14286
240,2,0,0,1,233,231,0.42857
840,0,1,0,1,800,800,0.42857
480,0,1,0,1,524,524,0.42857
840,-12,0,0,1,842,854,0.42857
240,0,1,1,1,205,205,0.57143
240,-4,0,1,2,222,226,0.71429
0,-7,0,0,3,24,31,0.14286
840,-7,0,0,1,830,837,0.42857
840,24,0,0,1,857,833,0.42857
240,0,1,1,1,255,255,0.57143
0,0,1,1,2,-14,-14,0.71429
480,0,1,0,3,471,471,0.14286
840,0,1,1,1,817,817,0.57143
240,-4,0,1,2,202,206,0.71429
480,0,1,1,2,494,494,0.71429
480,59,0,0,3,490,431,0.14286
480,0,1,1,2,489,489,0.71429
480,0,1,1,2,472,472,0.71429
840,0,1,0,2,816,816,0.28571
0,-5,0,1,2,-15,-10,0.71429
0,0,1,0,2,21,21,0.28571
480,0,1,1,2,469,469,0.71429
480,0,1,0,1,475,475,0.42857
0,43,0,0,3,23,-20,0.14286
480,12,0,0,2,485,473,0.28571
840,0,1,0,1,832,832,0.42857
240,0,1,0,1,314,314,0.42857
240,0,1,1,1,274,274,0.57143
840,-11,0,1,1,829,840,0.57143
840,-30,0,1,2,840,870,0.71429
0,0,1,1,2,-31,-31,0.71429
240,0,1,0,1,280,280,0.42857
480,0,1,1,1,524,524,0.57143
480,-29,0,0,1,454,483,0.42857
480,31,0,0,2,496,465,0.28571
0,-47,0,0,4,-46,1,0
480,12,0,1,1,491,479,0.57143
0,0,1,1,1,-16,-16,0.57143
240,95,0,0,3,276,181,0.14286
0,0,1,0,2,-16,-16,0.28571
480,0,1,1,1,496,496,0.57143
240,0,1,1,2,239,239,0.71429
0,0,1,1,2,-31,-31,0.71429
240,16,0,1,2,232,216,0.71429
840,26,0,0,2,855,829,0.28571
240,0,1,1,2,213,213,0.71429
480,5,0,1,2,459,454,0.71429
0,20,0,0,3,-5,-25,0.14286
480,-38,0,0,3,449,487,0.14286
240,0,1,1,1,239,239,0.57143
0,0,1,1,2,38,38,0.71429
240,-25,0,0,2,212,237,0.28571
0,0,1,1,2,5,5,0.71429
240,-19,0,0,2,236,255,0.28571
240,0,1,0,1,278,278,0.42857
0,0,1,0,1,26,26,0.42857
480,24,0,0,1,489,465,0.42857
480,-42,0,0,2,450,492,0.28571
0,-47,0,0,3,-3,44,0.14286
0,-8,0,0,2,-9,-1,0.28571
240,0,1,0,2,182,182,0.28571
240,-8,0,0,2,217,225,0.28571
240,0,1,0,1,213,213,0.42857
0,0,1,1,1,-10,-10,0.57143
0,0,1,1,2,-10,-10,0.71429
0,0,1,1,2,-41,-41,0.71429
240,0,1,1,2,272,272,0.71429
480,0,1,1,1,507,507,0.57143
480,0,1,1,1,496,496,0.57143
240,4,0,0,1,260,256,0.42857
240,0,1,0,1,246,246,0.42857
840,0,1,1,1,830,830,0.57143
840,48,0,0,2,886,838,0.28571
240,-49,0,0,3,213,262,0.14286
480,-10,0,0,2,473,483,0.28571
240,0,1,1,1,243,243,0.57143
840,-25,0,0,2,836,861,0.28571
0,-23,0,0,2,17,40,0.28571
480,-42,0,0,2,464,506,0.28571
480,0,1,0,2,455,455,0.28571
840,27,0,0,1,842,815,0.42857
480,0,1,1,1,493,493,0.57143
840,0,1,1,1,828,828,0.57143
480,-7,0,1,1,487,494,0.57143
0,0,1,1,2,-5,-5,0.71429
480,0,1,1,2,445,445,0.71429
840,2,0,1,1,855,853,0.57143
480,22,0,1,1,491,469,0.57143
840,32,0,0,2,864,832,0.28571
0,0,1,1,2,-13,-13,0.71429
480,39,0,0,2,472,433,0.28571
0,0,1,1,1,-2,-2,0.57143
840,0,1,0,1,836,836,0.42857
240,0,1,1,2,264,264,0.71429
840,0,1,0,1,847,847,0.42857
480,54,0,0,1,534,480,0.42857
840,0,1,0,2,835,835,0.28571
0,0,1,0,3,10,10,0.14286
480,-42,0,0,1,474,516,0.42857
480,43,0,0,2,483,440,0.28571
240,-18,0,0,2,172,190,0.28571
240,45,0,0,3,253,208,0.14286
480,36,0,0,2,478,442,0.28571
480,48,0,0,2,518,470,0.28571
480,0,1,0,2,480,480,0.28571
240,24,0,0,1,239,215,0.42857
480,43,0,0,2,473,430,0.28571
480,0,1,0,2,479,479,0.28571
0,0,1,0,1,-27,-27,0.42857
480,0,1,1,2,477,477,0.71429
0,6,0,0,2,-18,-24,0.28571
240,0,1,1,1,286,286,0.57143
0,13,0,0,3,22,9,0.14286
0,0,1,1,1,12,12,0.57143
0,-20,0,0,3,-14,6,0.14286
0,0,1,1,1,45,45,0.57143
840,-13,0,1,2,849,862,0.71429
0,2,0,1,2,-5,-7,0.71429
0,-42,0,0,4,-19,23,0
480,5,0,0,4,460,455,0
840,12,0,1,1,853,841,0.57143
480,0,1,0,2,488,488,0.28571
480,19,0,0,2,493,474,0.28571
480,10,0,0,2,484,474,0.28571
840,0,1,0,1,802,802,0.42857
480,0,1,0,1,460,460,0.42857
480,67,0,0,1,531,464,0.42857
840,-38,0,1,1,791,829,0.57143
840,0,1,1,1,831,831,0.57143
840,0,1,1,1,845,845,0.57143
0,8,0,1,1,4,-4,0.57143
240,-31,0,0,2,222,253,0.28571
240,0,1,0,2,229,229,0.28571
240,0,1,0,1,223,223,0.42857
0,0,1,0,1,-2,-2,0.42857
480,0,1,1,1,468,468,0.57143
0,0,1,0,1,6,6,0.42857
480,0,1,1,2,472,472,0.71429
840,0,1,1,1,855,855,0.57143
480,0,1,1,1,488,488,0.57143
240,0,1,1,2,226,226,0.71429
480,0,1,1,2,454,454,0.71429
240,-24,0,0,2,245,269,0.28571
240,-6,0,1,1,249,255,0.57143
480,-71,0,0,2,459,530,0.28571
840,0,1,0,3,849,849,0.14286
840,0,1,0,2,832,832,0.28571
0,0,1,1,1,8,8,0.57143
240,-1,0,1,1,208,209,0.57143
480,0,1,0,1,449,449,0.42857
480,-47,0,0,1,447,494,0.42857
240,0,1,1,2,250,250,0.71429
480,-13,0,0,2,437,450,0.28571
0,15,0,0,2,26,11,0.28571
480,0,1,1,2,460,460,0.71429
480,-34,0,0,3,465,499,0.14286
0,0,1,1,1,17,17,0.57143
240,0,1,1,2,279,279,0.71429
0,0,1,1,2,-7,-7,0.71429
480,0,1,1,1,500,500,0.57143
480,-9,0,1,1,476,485,0.57143
240,27,0,0,3,250,223,0.14286
840,-26,0,1,2,839,865,0.71429
840,24,0,1,1,819,795,0.57143
840,57,0,0,2,861,804,0.28571
840,0,1,0,2,845,845,0.28571
240,-9,0,0,1,245,254,0.42857
480,0,1,0,2,495,495,0.28571
480,-14,0,0,1,472,486,0.42857
480,31,0,0,2,483,452,0.28571
0,0,1,1,2,18,18,0.71429
840,0,1,0,1,851,851,0.42857
0,0,1,1,2,-24,-24,0.71429
0,0,1,1,1,2,2,0.57143
240,0,1,0,1,223,223,0.42857
240,-96,0,0,3,199,295,0.14286
240,0,1,0,2,242,242,0.28571
840,-28,0,0,1,840,868,0.42857
0,-26,0,0,3,-14,12,0.14286
0,0,1,1,1,-1,-1,0.57143
240,0,1,1,2,223,223,0.71429
480,-25,0,0,1,438,463,0.42857
240,14,0,1,2,234,220,0.71429
840,0,1,0,2,858,858,0.28571
240,67,0,0,3,266,199,0.14286
840,0,1,0,1,823,823,0.42857
840,58,0,0,1,870,812,0.42857
840,-1,0,0,2,826,827,0.28571
480,0,1,0,1,513,513,0.42857
480,51,0,0,2,504,453,0.28571
240,0,1,0,2,226,226,0.28571
0,-30,0,0,3,-20,10,0.14286
0,54,0,0,4,11,-43,0
0,0,1,0,2,-19,-19,0.28571
0,0,1,1,1,0,0,0.57143
840,0,1,0,2,845,845,0.28571
480,0,1,1,1,470,470,0.57143
840,-34,0,0,2,827,861,0.28571
480,-36,0,0,2,474,510,0.28571
840,53,0,1,1,879,826,0.57143
480,89,0,0,3,516,427,0.14286
840,0,1,1,1,822,822,0.57143
240,0,1,1,1,263,263,0.57143
840,14,0,0,1,844,830,0.42857
0,34,0,0,3,30,-4,0.14286
480,45,0,0,2,497,452,0.28571
840,46,0,0,2,876,830,0.28571
840,0,1,0,2,822,822,0.28571
240,37,0,0,2,279,242,0.28571
480,0,1,1,2,488,488,0.71429
240,0,1,1,1,173,173,0.57143
840,26,0,1,2,843,817,0.71429
240,14,0,0,1,236,222,0.42857
240,-8,0,1,2,223,231,0.71429
0,0,1,1,2,31,31,0.71429
240,5,0,1,2,229,224,0.71429
840,14,0,1,2,871,857,0.71429
240,82,0,0,3,296,214,0.14286
0,-23,0,0,2,-15,8,0.28571
480,0,1,1,1,481,481,0.57143
240,0,1,1,1,223,223,0.57143
0,-18,0,0,1,-18,-0,0.42857
840,0,1,1,1,865,865,0.57143
240,0,1,1,2,205,205,0.71429
480,-3,0,1,1,485,488,0.57143
0,0,1,1,2,13,13,0.71429
0,0,1,0,1,25,25,0.42857
240,0,1,1,2,264,264,0.71429
0,-16,0,0,3,-14,2,0.14286
0,0,1,0,1,8,8,0.42857
480,45,0,0,3,525,480,0.14286
240,0,1,1,2,212,212,0.71429
0,-3,0,1,1,-7,-4,0.57143
0,-7,0,1,2,24,31,0.71429
480,0,1,1,1,506,506,0.57143
840,-3,0,1,1,864,867,0.57143
840,0,1,1,1,843,843,0.57143
480,-19,0,1,1,468,487,0.57143
840,0,1,0,1,850,850,0.42857
240,0,1,1,1,228,228,0.57143
0,30,0,0,3,-8,-38,0.14286
840,10,0,0,1,861,851,0.42857
480,-1,0,0,1,491,492,0.42857
240,0,1,1,1,239,239,0.57143
0,0,1,1,1,39,39,0.57143
840,-13,0,1,1,829,842,0.57143
0,72,0,0,3,30,-42,0.14286
840,0,1,1,1,832,832,0.57143
0,-26,0,0,3,-2,24,0.14286
840,0,1,1,1,832,832,0.57143
840,-76,0,0,3,798,874,0.14286
840,41,0,1,1,873,832,0.57143
240,49,0,0,3,261,212,0.14286
240,39,0,0,2,245,206,0.28571
0,-17,0,0,3,-19,-2,0.14286
240,-13,0,0,2,243,256,0.28571
840,0,1,0,1,835,835,0.42857
840,32,0,1,1,854,822,0.57143
480,-5,0,1,1,475,480,0.57143
480,0,1,1,1,504,504,0.57143
240,0,1,0,1,227,227,0.42857
0,0,1,1,1,-8,-8,0.57143
240,-6,0,0,1,230,236,0.42857
480,-19,0,0,1,470,489,0.42857
240,-59,0,0,2,188,247,0.28571
840,0,1,1,1,849,849,0.57143
480,0,1,1,1,513,513,0.57143
0,0,1,1,1,29,29,0.57143
480,0,1,1,2,490,490,0.71429
240,-21,0,0,2,181,202,0.28571
240,24,0,0,3,249,225,0.14286
0,0,1,1,1,22,22,0.57143
240,-74,0,0,3,207,281,0.14286
840,-17,0,1,1,840,857,0.57143
840,0,1,1,1,838,838,0.57143
840,36,0,1,1,858,822,0.57143
840,0,1,1,2,872,872,0.71429
480,0,1,1,1,525,525,0.57143
0,0,1,0,1,40,40,0.42857
480,-25,0,1,1,461,486,0.57143
240,0,1,1,1,239,239,0.57143
0,89,0,0,3,74,-15,0.14286
0,0,1,1,2,-21,-21,0.71429
840,-54,0,0,3,805,859,0.14286
840,0,1,1,1,802,802,0.57143
480,0,1,1,2,471,471,0.71429
0,0,1,0,1,11,11,0.42857
480,0,1,0,1,493,493,0.42857
0,0,1,1,2,-44,-44,0.71429
840,0,1,1,1,824,824,0.57143
840,0,1,1,1,798,798,0.57143
0,-30,0,0,3,-20,10,0.14286
840,0,1,1,1,839,839,0.57143
0,24,0,0,3,11,-13,0.14286
840,8,0,0,1,845,837,0.42857
0,0,1,0,2,18,18,0.28571
840,17,0,1,1,851,834,0.57143
0,47,0,0,3,19,-28,0.14286
840,-3,0,1,1,867,870,0.57143
480,0,1,1,1,488,488,0.57143
240,-16,0,1,2,246,262,0.71429
840,45,0,0,3,869,824,0.14286
840,26,0,0,1,872,846,0.42857
840,0,1,1,1,855,855,0.57143
240,0,1,1,2,268,268,0.71429
480,-24,0,0,1,474,498,0.42857
840,0,1,1,2,792,792,0.71429
240,0,1,1,1,271,271,0.57143
840,0,1,1,2,853,853,0.71429
0,-5,0,1,2,-22,-17,0.71429
240,-42,0,0,3,198,240,0.14286
240,0,1,0,1,266,266,0.42857
840,0,1,1,1,834,834,0.57143
480,0,1,1,1,419,419,0.57143
240,27,0,0,1,290,263,0.42857
0,0,1,1,1,15,15,0.57143
840,71,0,0,3,892,821,0.14286
480,32,0,0,2,496,464,0.28571
240,0,1,0,2,232,232,0.28571
840,-3,0,0,1,849,852,0.42857
480,-50,0,0,3,481,531,0.14286
840,0,1,1,1,802,802,0.57143
840,0,1,0,2,826,826,0.28571
240,0,1,1,1,226,226,0.57143
240,0,1,1,2,272,272,0.71429
0,0,1,1,3,2,2,0.85714
480,21,0,0,3,467,446,0.14286
840,0,1,0,1,841,841,0.42857
0,-8,0,0,2,-37,-29,0.28571
240,0,1,1,2,239,239,0.71429
240,0,1,1,2,202,202,0.71429
480,-53,0,0,3,428,481,0.14286
0,-42,0,0,3,-35,7,0.14286
240,-32,0,0,2,226,258,0.28571
480,-10,0,0,2,474,484,0.28571
840,0,1,1,2,814,814,0.71429
240,38,0,0,3,275,237,0.14286
840,0,1,1,2,829,829,0.71429
480,-54,0,0,3,417,471,0.14286
240,-2,0,1,1,246,248,0.57143
480,-9,0,0,1,457,466,0.42857
840,0,1,0,1,788,788,0.42857
480,0,1,0,1,449,449,0.42857
840,-55,0,0,3,827,882,0.14286
0,-31,0,0,3,-44,-13,0.14286
840,0,1,0,1,855,855,0.42857
480,44,0,0,3,529,485,0.14286
240,-32,0,0,2,225,257,0.28571
840,49,0,0,2,877,828,0.28571
240,35,0,0,1,235,200,0.42857
840,19,0,0,2,842,823,0.28571
240,0,1,1,2,268,268,0.71429
0,16,0,0,4,4,-12,0
840,7,0,0,1,858,851,0.42857
480,0,1,1,1,501,501,0.57143
840,53,0,1,2,910,857,0.71429
240,-26,0,0,2,242,268,0.28571
0,0,1,0,2,-37,-37,0.28571
240,34,0,1,2,274,240,0.71429
240,0,1,0,1,251,251,0.42857
840,-31,0,1,1,835,866,0.57143
0,3,0,0,1,-7,-10,0.42857
240,0,1,1,2,275,275,0.71429
840,0,1,1,1,864,864,0.57143
840,0,1,1,1,881,881,0.57143
240,13,0,0,2,254,241,0.28571
240,0,1,1,2,236,236,0.71429
480,0,1,0,2,499,499,0.28571
840,0,1,1,1,844,844,0.57143
0,0,1,1,1,38,38,0.57143
840,0,1,1,1,803,803,0.57143
480,0,1,1,1,464,464,0.57143
240,0,1,1,2,230,230,0.71429
0,0,1,1,2,2,2,0.71429
0,54,0,0,3,31,-23,0.14286
0,0,1,1,1,-3,-3,0.57143
840,14,0,1,2,859,845,0.71429
480,5,0,1,2,476,471,0.71429
480,35,0,0,2,512,477,0.28571
240,0,1,1,2,228,228,0.71429
840,75,0,0,3,887,812,0.14286
240,-58,0,0,3,193,251,0.14286
0,8,0,0,2,-1,-9,0.28571
840,-17,0,0,2,849,866,0.28571
0,0,1,1,2,37,37,0.71429
480,-11,0,0,2,452,463,0.28571
240,0,1,0,2,240,240,0.28571
480,13,0,1,2,462,449,0.71429
840,0,1,1,2,832,832,0.71429
840,0,1,1,2,840,840,0.71429
0,15,0,0,3,-4,-19,0.14286
840,0,1,1,2,848,848,0.71429
240,0,1,1,2,277,277,0.71429
240,-33,0,0,2,227,260,0.28571
840,0,1,0,1,845,845,0.42857
0,0,1,1,1,-16,-16,0.57143
0,0,1,1,1,22,22,0.57143
480,38,0,0,2,493,455,0.28571
240,0,1,1,1,248,248,0.57143
0,28,0,0,3,16,-12,0.14286
840,0,1,0,2,843,843,0.28571
840,0,1,1,1,878,878,0.57143
0,0,1,0,1,10,10,0.42857
240,43,0,0,3,265,222,0.14286
840,0,1,0,1,819,819,0.42857
240,71,0,0,3,267,196,0.14286
840,3,0,1,1,840,837,0.57143
0,13,0,0,2,9,-4,0.28571
0,-8,0,0,1,7,15,0.42857
0,0,1,1,2,39,39,0.71429
480,0,1,0,1,508,508,0.42857
0,0,1,1,1,-37,-37,0.57143
480,-51,0,0,2,432,483,0.28571
0,12,0,0,2,17,5,0.28571
240,-16,0,0,2,211,227,0.28571
480,34,0,0,1,469,435,0.42857
0,0,1,1,2,-10,-10,0.71429
840,0,1,1,1,846,846,0.57143
480,0,1,1,1,467,467,0.57143
480,0,1,1,1,505,505,0.57143
840,0,1,1,1,817,817,0.57143
480,43,0,0,3,517,474,0.14286
0,54,0,0,4,30,-24,0
0,9,0,0,3,-21,-30,0.14286
240,0,1,1,1,274,274,0.57143
0,0,1,1,1,18,18,0.57143
840,-16,0,1,1,843,859,0.57143
240,43,0,0,2,272,229,0.28571
480,0,1,1,1,472,472,0.57143
0,0,1,1,1,9,9,0.57143
480,14,0,0,2,489,475,0.28571
0,3,0,1,2,-16,-19,0.71429
840,0,1,1,2,846,846,0.71429
480,0,1,1,2,463,463,0.71429
480,0,1,1,2,502,502,0.71429
840,0,1,1,2,857,857,0.71429
840,0,1,1,2,843,843,0.71429
240,0,1,1,1,245,245,0.57143
840,0,1,1,2,852,852,0.71429
480,0,1,1,2,454,454,0.71429
840,-22,0,1,2,817,839,0.71429
840,0,1,1,2,841,841,0.71429
240,27,0,0,2,272,245,0.28571
480,-49,0,0,2,470,519,0.28571
240,0,1,0,1,235,235,0.42857
240,0,1,1,1,268,268,0.57143
0,0,1,1,2,-0,-0,0.71429
840,34,0,1,1,854,820,0.57143
840,64,0,0,2,867,803,0.28571
840,0,1,0,2,824,824,0.28571
480,27,0,0,1,470,443,0.42857
840,-39,0,0,1,828,867,0.42857
0,-10,0,0,1,-47,-37,0.42857
480,0,1,1,1,469,469,0.57143
480,-38,0,0,2,472,510,0.28571
480,1,0,1,1,516,515,0.57143
240,0,1,1,1,286,286,0.57143
240,0,1,1,1,234,234,0.57143
480,0,1,1,1,480,480,0.57143
840,0,1,1,1,830,830,0.57143
840,34,0,0,1,833,799,0.42857
240,0,1,0,1,258,258,0.42857
840,72,0,0,2,887,815,0.28571
840,-50,0,0,2,839,889,0.28571
0,32,0,0,2,5,-27,0.28571
0,-27,0,0,3,-10,17,0.14286
840,0,1,1,1,842,842,0.57143
0,0,1,0,1,22,22,0.42857
480,15,0,1,1,486,471,0.57143
240,0,1,1,1,275,275,0.57143
0,0,1,1,2,-9,-9,0.71429
0,0,1,1,2,-51,-51,0.71429
240,49,0,0,3,266,217,0.14286
240,14,0,0,4,223,209,0
840,-97,0,0,3,823,920,0.14286
0,22,0,0,3,8,-14,0.14286
240,24,0,0,2,275,251,0.28571
840,31,0,0,2,848,817,0.28571
480,0,1,1,2,471,471,0.71429
840,-76,0,0,3,805,881,0.14286
840,0,1,1,1,819,819,0.57143
480,0,1,1,1,543,543,0.57143
240,0,1,1,1,241,241,0.57143
240,-16,0,0,1,236,252,0.42857
480,0,1,1,1,486,486,0.57143
840,0,1,1,1,879,879,0.57143
240,-2,0,1,1,256,258,0.57143
480,0,1,1,2,483,483,0.71429
240,-27,0,1,2,222,249,0.71429
840,-14,0,1,1,840,854,0.57143
480,0,1,0,1,472,472,0.42857
0,0,1,1,1,-3,-3,0.57143
240,-12,0,0,1,245,257,0.42857
0,0,1,1,2,13,13,0.71429
0,-11,0,0,2,-18,-7,0.28571
0,0,1,0,1,-29,-29,0.42857
240,0,1,1,1,233,233,0.57143
240,12,0,0,2,238,226,0.28571
840,0,1,1,2,838,838,0.71429
480,0,1,0,2,464,464,0.28571
0,-33,0,0,3,-25,8,0.14286
240,-10,0,0,1,209,219,0.42857
840,0,1,1,1,803,803,0.57143
840,-30,0,0,2,823,853,0.28571
480,8,0,1,1,504,496,0.57143
840,-61,0,0,2,805,866,0.28571
840,-17,0,0,2,853,870,0.28571
480,0,1,0,1,495,495,0.42857
240,0,1,1,1,266,266,0.57143
0,-16,0,0,2,-6,10,0.28571
0,0,1,1,1,12,12,0.57143
0,2,0,1,1,-30,-32,0.57143
240,0,1,1,1,188,188,0.57143
0,-15,0,0,2,-16,-1,0.28571
480,0,1,1,2,487,487,0.71429
240,-71,0,0,3,195,266,0.14286
0,0,1,1,1,-23,-23,0.57143
480,0,1,1,1,491,491,0.57143
0,0,1,0,2,27,27,0.28571
840,21,0,0,2,824,803,0.28571
480,-9,0,1,2,483,492,0.71429
480,0,1,1,2,472,472,0.71429
0,0,1,1,1,13,13,0.57143
480,0,1,1,2,479,479,0.71429
480,-83,0,0,3,448,531,0.14286
0,0,1,1,2,7,7,0.71429
480,-12,0,1,1,475,487,0.57143
240,57,0,0,3,284,227,0.14286
480,0,1,0,2,507,507,0.28571
480,7,0,0,2,477,470,0.28571
240,-28,0,0,3,233,261,0.14286
840,0,1,0,2,839,839,0.28571
0,2,0,0,1,-8,-10,0.42857
240,-12,0,1,1,246,258,0.57143
480,0,1,1,2,445,445,0.71429
840,0,1,1,1,828,828,0.57143
240,-3,0,1,1,241,244,0.57143
0,-48,0,0,3,-25,23,0.14286
840,35,0,0,1,856,821,0.42857
480,18,0,0,2,478,460,0.28571
240,-23,0,0,1,229,252,0.42857
0,0,1,0,2,16,16,0.28571
480,0,1,1,1,469,469,0.57143
0,17,0,0,2,-13,-30,0.28571
480,-22,0,0,2,469,491,0.28571
840,18,0,1,1,845,827,0.57143
240,34,0,0,3,259,225,0.14286
840,0,1,0,2,903,903,0.28571
480,0,1,0,2,482,482,0.28571
840,16,0,0,1,825,809,0.42857
840,-43,0,0,3,799,842,0.14286
840,0,1,0,2,871,871,0.28571
0,49,0,0,3,49,-0,0.14286
840,0,1,0,1,848,848,0.42857
840,0,1,0,1,835,835,0.42857
240,-19,0,1,1,204,223,0.57143
480,0,1,1,1,509,509,0.57143
480,0,1,1,1,488,488,0.57143
480,-42,0,0,3,466,508,0.14286
840,41,0,0,1,856,815,0.42857
240,19,0,0,1,246,227,0.42857
240,33,0,0,2,220,187,0.28571
840,0,1,1,1,823,823,0.57143
480,0,1,1,1,467,467,0.57143
840,0,1,1,1,796,796,0.57143
840,-14,0,1,1,845,859,0.57143
240,0,1,1,1,253,253,0.57143
480,-8,0,1,1,503,511,0.57143
240,17,0,1,1,248,231,0.57143
240,-22,0,0,2,230,252,0.28571
0,6,0,0,2,34,28,0.28571
480,0,1,0,1,446,446,0.42857
0,77,0,0,3,56,-21,0.14286
840,0,1,0,2,861,861,0.28571
240,0,1,0,1,193,193,0.42857
240,-26,0,0,3,226,252,0.14286
240,37,0,0,3,234,197,0.14286
240,-3,0,0,2,263,266,0.28571
240,-7,0,0,2,241,248,0.28571
840,0,1,1,1,814,814,0.57143
840,0,1,0,1,837,837,0.42857
240,12,0,1,1,236,224,0.57143
840,0,1,0,1,852,852,0.42857
840,0,1,1,1,847,847,0.57143
240,0,1,1,2,246,246,0.71429
240,54,0,0,3,268,214,0.14286
0,0,1,1,2,27,27,0.71429
0,0,1,1,2,60,60,0.71429
240,-26,0,0,3,233,259,0.14286
240,0,1,1,2,231,231,0.71429
0,13,0,0,3,4,-9,0.14286
480,20,0,0,2,498,478,0.28571
240,-16,0,0,1,247,263,0.42857
480,24,0,1,2,478,454,0.71429
0,0,1,1,2,-20,-20,0.71429
480,-55,0,0,3,428,483,0.14286
840,-65,0,0,2,813,878,0.28571
840,0,1,0,2,871,871,0.28571
240,4,0,0,2,209,205,0.28571
0,0,1,1,1,35,35,0.57143
0,0,1,1,1,-6,-6,0.57143
0,49,0,0,3,16,-33,0.14286
480,0,1,1,1,440,440,0.57143
0,42,0,0,3,35,-7,0.14286
0,0,1,1,1,40,40,0.57143
840,37,0,0,3,835,798,0.14286
240,0,1,0,1,229,229,0.42857
480,81,0,0,3,487,406,0.14286
480,94,0,0,3,537,443,0.14286
0,-23,0,0,4,-24,-1,0
840,18,0,0,1,856,838,0.42857
840,0,1,0,1,851,851,0.42857
480,2,0,0,1,460,458,0.42857
480,11,0,1,1,511,500,0.57143
840,0,1,0,1,858,858,0.42857
480,0,1,1,1,488,488,0.57143
480,0,1,0,1,505,505,0.42857
0,0,1,0,2,37,37,0.28571
240,0,1,1,1,242,242,0.57143
240,0,1,1,2,261,261,0.71429
480,-13,0,0,1,502,515,0.42857
240,0,1,1,2,220,220,0.71429
240,0,1,1,2,238,238,0.71429
840,0,1,1,1,885,885,0.57143
480,0,1,0,1,474,474,0.42857
0,-5,0,1,1,-20,-15,0.57143
0,0,1,1,2,-20,-20,0.71429
0,56,0,0,3,23,-33,0.14286
0,0,1,1,1,2,2,0.57143
480,0,1,1,1,458,458,0.57143
480,10,0,1,1,484,474,0.57143
480,0,1,1,1,462,462,0.57143
0,-31,0,0,3,-11,20,0.14286
240,0,1,1,1,241,241,0.57143
240,0,1,1,1,299,299,0.57143
840,0,1,1,1,819,819,0.57143
240,0,1,1,1,188,188,0.57143
240,0,1,1,1,214,214,0.57143
240,19,0,1,1,266,247,0.57143
240,-17,0,1,1,231,248,0.57143
480,-73,0,0,3,431,504,0.14286
840,48,0,0,2,872,824,0.28571
480,0,1,0,1,447,447,0.42857
0,0,1,1,2,-9,-9,0.71429
480,0,1,0,3,496,496,0.14286
240,-52,0,0,2,185,237,0.28571
0,0,1,1,1,-15,-15,0.57143
240,0,1,1,1,255,255,0.57143
480,-6,0,1,2,491,497,0.71429
480,0,1,0,1,506,506,0.42857
480,-18,0,1,1,473,491,0.57143
480,-8,0,1,1,481,489,0.57143
0,-22,0,0,3,-3,19,0.14286
0,0,1,1,1,8,8,0.57143
840,6,0,0,1,851,845,0.42857
840,6,0,0,1,839,833,0.42857
480,19,0,0,2,486,467,0.28571
480,0,1,0,2,477,477,0.28571
0,-27,0,0,3,-47,-20,0.14286
0,0,1,1,1,33,33,0.57143
840,4,0,1,2,822,818,0.71429
840,40,0,1,1,872,832,0.57143
240,-12,0,1,1,205,217,0.57143
0,-45,0,0,2,-10,35,0.28571
0,0,1,0,2,-11,-11,0.28571
0,0,1,1,1,-24,-24,0.57143
840,24,0,1,1,845,821,0.57143
840,-14,0,1,1,855,869,0.57143
840,-6,0,1,1,847,853,0.57143
240,-3,0,1,1,214,217,0.57143
240,0,1,1,1,239,239,0.57143
480,0,1,1,1,520,520,0.57143
480,0,1,1,1,487,487,0.57143
0,0,1,1,1,13,13,0.57143
480,13,0,1,2,480,467,0.71429
0,0,1,1,1,27,27,0.57143
240,35,0,0,3,267,232,0.14286
240,0,1,0,2,256,256,0.28571
840,0,1,1,1,823,823,0.57143
840,-28,0,1,1,823,851,0.57143
0,0,1,1,1,-13,-13,0.57143
0,19,0,0,3,-20,-39,0.14286
0,0,1,1,1,-16,-16,0.57143
480,0,1,0,2,463,463,0.28571
840,0,1,0,1,827,827,0.42857
840,0,1,1,1,851,851,0.57143
240,30,0,0,2,254,224,0.28571
0,14,0,0,2,10,-4,0.28571
240,34,0,1,2,269,235,0.71429
0,17,0,0,2,-19,-36,0.28571
480,-4,0,1,1,493,497,0.57143
0,-50,0,0,3,-6,44,0.14286
240,0,1,1,2,267,267,0.71429
840,28,0,0,1,846,818,0.42857
240,13,0,0,2,229,216,0.28571
480,0,1,1,1,506,506,0.57143
840,-16,0,1,1,829,845,0.57143
240,-23,0,0,1,256,279,0.42857
240,0,1,1,1,267,267,0.57143
0,-34,0,0,3,-22,12,0.14286
480,39,0,0,3,498,459,0.14286
0,-36,0,0,3,0,36,0.14286
0,0,1,1,1,-5,-5,0.57143
840,-2,0,1,1,849,851,0.57143
240,0,1,1,1,242,242,0.57143
840,0,1,1,1,837,837,0.57143
240,0,1,1,1,275,275,0.57143
840,-7,0,1,1,849,856,0.57143
0,-22,0,0,2,-35,-13,0.28571
480,1,0,1,1,470,469,0.57143
240,0,1,1,1,267,267,0.57143
0,-25,0,0,3,-4,21,0.14286
0,-43,0,0,3,-20,23,0.14286
480,-15,0,0,2,476,491,0.28571
480,-17,0,0,2,470,487,0.28571
480,19,0,1,1,478,459,0.57143
240,0,1,0,1,245,245,0.42857
240,22,0,0,2,241,219,0.28571
0,-10,0,0,2,26,36,0.28571
480,74,0,0,3,517,443,0.14286
0,0,1,1,1,-41,-41,0.57143
840,-30,0,0,1,817,847,0.42857
480,0,1,0,1,474,474,0.42857
480,0,1,1,1,491,491,0.57143
0,0,1,1,1,11,11,0.57143
0,0,1,0,1,13,13,0.42857
840,-24,0,0,2,832,856,0.28571
0,-16,0,0,2,-4,12,0.28571
840,-55,0,0,2,804,859,0.28571
480,0,1,0,1,491,491,0.42857
240,0,1,1,1,198,198,0.57143
0,-22,0,0,2,-15,7,0.28571
0,0,1,1,2,-28,-28,0.71429
840,0,1,1,1,857,857,0.57143
480,-34,0,0,3,457,491,0.14286
840,38,0,0,1,832,794,0.42857
480,0,1,1,1,493,493,0.57143
480,-12,0,1,1,443,455,0.57143
840,0,1,1,1,849,849,0.57143
840,0,1,1,1,816,816,0.57143
480,0,1,1,2,485,485,0.71429
480,0,1,1,2,476,476,0.71429
480,0,1,0,1,476,476,0.42857
480,0,1,0,1,479,479,0.42857
0,0,1,1,2,7,7,0.71429
840,-45,0,0,1,803,848,0.42857
0,0,1,1,2,1,1,0.71429
0,-7,0,1,2,-5,2,0.71429
0,0,1,1,1,18,18,0.57143
0,0,1,1,2,8,8,0.71429
0,-50,0,0,3,-10,40,0.14286
240,0,1,1,2,207,207,0.71429
840,0,1,1,1,894,894,0.57143
480,0,1,1,2,427,427,0.71429
0,13,0,0,3,27,14,0.14286
480,-23,0,1,2,487,510,0.71429
0,13,0,0,3,-9,-22,0.14286
840,20,0,0,2,850,830,0.28571
840,0,1,0,2,835,835,0.28571
240,0,1,0,2,252,252,0.28571
840,-1,0,0,1,817,818,0.42857
480,-25,0,0,2,443,468,0.28571
240,0,1,1,1,181,181,0.57143
240,0,1,1,2,265,265,0.71429
840,0,1,1,1,838,838,0.57143
480,0,1,1,2,484,484,0.71429
240,-24,0,1,2,238,262,0.71429
240,0,1,1,2,221,221,0.71429
480,34,0,1,2,503,469,0.71429
480,30,0,1,2,535,505,0.71429
840,-3,0,1,1,810,813,0.57143
0,0,1,1,2,-3,-3,0.71429
840,0,1,1,2,856,856,0.71429
480,0,1,1,2,477,477,0.71429
240,-19,0,1,2,227,246,0.71429
240,0,1,1,2,222,222,0.71429
240,42,0,0,3,294,252,0.14286
240,0,1,1,2,228,228,0.71429
840,-49,0,0,3,844,893,0.14286
0,0,1,1,2,-4,-4,0.71429
0,0,1,1,2,-32,-32,0.71429
480,0,1,1,2,495,495,0.71429
240,0,1,1,2,251,251,0.71429
240,-13,0,1,2,226,239,0.71429
240,-16,0,1,2,238,254,0.71429
840,9,0,1,1,852,843,0.57143
840,0,1,1,1,860,860,0.57143
840,0,1,0,1,826,826,0.42857
480,0,1,1,1,496,496,0.57143
480,4,0,0,1,487,483,0.42857
240,0,1,1,1,231,231,0.57143
0,0,1,0,1,-9,-9,0.42857
0,9,0,0,2,8,-1,0.28571
0,-70,0,0,3,-31,39,0.14286
840,0,1,0,1,829,829,0.42857
240,0,1,1,1,247,247,0.57143
240,9,0,0,2,265,256,0.28571
240,0,1,1,1,223,223,0.57143
0,0,1,1,1,-22,-22,0.57143
240,5,0,1,1,238,233,0.57143
480,-1,0,1,1,477,478,0.57143
240,29,0,0,2,241,212,0.28571
240,0,1,0,1,224,224,0.42857
240,-40,0,0,3,242,282,0.14286
240,0,1,0,2,183,183,0.28571
0,0,1,1,2,44,44,0.71429
480,24,0,0,1,514,490,0.42857
240,0,1,1,1,269,269,0.57143
240,10,0,1,1,213,203,0.57143
240,29,0,0,2,245,216,0.28571
840,0,1,1,1,849,849,0.57143
480,0,1,1,1,444,444,0.57143
480,56,0,0,2,508,452,0.28571
480,0,1,1,2,452,452,0.71429
480,0,1,1,1,436,436,0.57143
0,0,1,0,1,-20,-20,0.42857
480,-59,0,0,3,416,475,0.14286
0,-59,0,0,3,-53,6,0.14286
840,-19,0,1,1,808,827,0.57143
840,0,1,1,1,824,824,0.57143
0,0,1,1,1,-16,-16,0.57143
0,0,1,1,1,18,18,0.57143
840,-17,0,1,1,819,836,0.57143
0,0,1,1,1,5,5,0.57143
240,59,0,0,3,229,170,0.14286
240,0,1,1,1,199,199,0.57143
480,0,1,1,1,495,495,0.57143
0,31,0,0,2,11,-20,0.28571
0,0,1,1,1,33,33,0.57143
480,15,0,0,2,499,484,0.28571
240,-1,0,0,2,231,232,0.28571
840,0,1,0,2,870,870,0.28571
240,10,0,0,1,251,241,0.42857
480,0,1,0,1,468,468,0.42857
840,-24,0,0,1,829,853,0.42857
480,41,0,0,2,517,476,0.28571
0,-13,0,0,3,-5,8,0.14286
480,0,1,0,1,487,487,0.42857
240,20,0,0,2,247,227,0.28571
0,0,1,1,1,25,25,0.57143
840,0,1,1,1,844,844,0.57143
0,-34,0,0,3,-37,-3,0.14286
240,0,1,0,2,282,282,0.28571
240,36,0,0,3,263,227,0.14286
240,0,1,0,2,253,253,0.28571
0,18,0,0,3,17,-1,0.14286
480,-2,0,1,2,479,481,0.71429
480,-31,0,0,1,465,496,0.42857
480,-32,0,0,2,453,485,0.28571
0,0,1,1,1,-21,-21,0.57143
840,-3,0,0,2,835,838,0.28571
480,-47,0,0,2,451,498,0.28571
240,-27,0,0,1,214,241,0.42857
240,17,0,1,2,225,208,0.71429
480,0,1,1,2,473,473,0.71429
0,-2,0,1,2,15,17,0.71429
840,0,1,1,1,836,836,0.57143
480,-25,0,0,1,482,507,0.42857
0,0,1,1,1,-5,-5,0.57143
0,0,1,1,1,-11,-11,0.57143
0,0,1,1,1,-4,-4,0.57143
480,0,1,1,1,482,482,0.57143
480,6,0,1,1,472,466,0.57143
480,0,1,0,1,466,466,0.42857
0,0,1,0,1,-13,-13,0.42857
480,51,0,0,3,488,437,0.14286
840,0,1,0,2,876,876,0.28571
240,0,1,1,1,245,245,0.57143
0,34,0,0,3,6,-28,0.14286
240,0,1,0,1,244,244,0.42857
0,-41,0,0,3,-31,10,0.14286
840,0,1,0,1,842,842,0.42857
480,17,0,0,2,479,462,0.28571
240,-51,0,0,3,249,300,0.14286
0,14,0,0,1,25,11,0.42857
480,14,0,1,1,470,456,0.57143
