840,0,1,1,2,853,853,0.71429
480,0,1,1,3,508,508,0.85714
240,-52,0,0,3,231,283,0.14286
0,83,0,0,4,46,-37,0
240,22,0,0,3,252,230,0.14286
840,0,1,1,2,820,820,0.71429
240,0,1,0,2,236,236,0.28571
240,0,1,1,2,194,194,0.71429
0,-51,0,0,4,4,55,0
0,0,1,1,4,-44,-44,1
480,-40,0,0,2,461,501,0.28571
480,12,0,1,1,499,487,0.57143
840,-21,0,1,2,828,849,0.71429
840,48,0,0,2,869,821,0.28571
480,0,1,0,2,474,474,0.28571
0,40,0,0,3,20,-20,0.14286
240,0,1,1,4,240,240,1
0,-28,0,0,3,-28,0,0.14286
480,-18,0,0,2,485,503,0.28571
840,0,1,1,2,833,833,0.71429
840,39,0,0,2,871,832,0.28571
240,-32,0,0,2,198,230,0.28571
480,0,1,1,2,455,455,0.71429
0,51,0,0,3,45,-6,0.14286
480,16,0,0,3,496,480,0.14286
840,-28,0,1,3,817,845,0.85714
0,-37,0,0,4,-27,10,0
840,0,1,1,2,840,840,0.71429
840,0,1,1,3,850,850,0.85714
0,67,0,0,1,33,-34,0.42857
840,-93,0,0,3,833,926,0.14286
0,0,1,1,2,-7,-7,0.71429
480,-10,0,1,3,452,462,0.85714
0,0,1,1,1,-24,-24,0.57143
0,0,1,1,3,-37,-37,0.85714
0,0,1,0,2,37,37,0.28571
480,0,1,1,4,476,476,1
240,0,1,1,2,250,250,0.71429
840,37,0,1,2,860,823,0.71429
0,15,0,0,2,10,-5,0.28571
0,39,0,0,3,13,-26,0.14286
240,-22,0,1,3,218,240,0.85714
840,0,1,1,3,796,796,0.85714
840,0,1,1,4,820,820,1
0,0,1,1,2,-5,-5,0.71429
480,0,1,1,3,468,468,0.85714
0,-16,0,0,2,15,31,0.28571
840,24,0,0,2,856,832,0.28571
840,-11,0,1,3,850,861,0.85714
240,0,1,1,3,244,244,0.85714
840,7,0,1,3,854,847,0.85714
240,-90,0,0,3,185,275,0.14286
0,0,1,1,2,-10,-10,0.71429
480,11,0,1,2,477,466,0.71429
480,0,1,1,3,502,502,0.85714
240,27,0,0,3,243,216,0.14286
0,0,1,1,4,49,49,1
0,49,0,0,3,3,-46,0.14286
0,0,1,1,3,2,2,0.85714
480,0,1,1,3,514,514,0.85714
240,0,1,1,2,231,231,0.71429
240,0,1,1,1,188,188,0.57143
0,15,0,0,2,-23,-38,0.28571
480,13,0,1,3,505,492,0.85714
240,0,1,0,2,255,255,0.28571
240,31,0,0,3,245,214,0.14286
480,0,1,1,3,477,477,0.85714
240,0,1,0,1,249,249,0.42857
0,0,1,1,1,-5,-5,0.57143
240,0,1,0,1,264,264,0.42857
0,-36,0,0,4,-19,17,0
840,0,1,1,2,898,898,0.71429
240,0,1,0,2,244,244,0.28571
480,-6,0,1,3,467,473,0.85714
0,-8,0,0,1,-13,-5,0.42857
840,-55,0,0,2,801,856,0.28571
240,0,1,0,1,234,234,0.42857
240,39,0,0,3,230,191,0.14286
480,0,1,1,3,434,434,0.85714
240,4,0,0,2,221,217,0.28571
0,0,1,1,3,-39,-39,0.85714
0,-32,0,0,4,-14,18,0
480,0,1,1,2,505,505,0.71429
480,-24,0,1,3,454,478,0.85714
840,-32,0,1,2,826,858,0.71429
840,14,0,1,1,869,855,0.57143
840,0,1,1,3,829,829,0.85714
0,-22,0,0,3,-9,13,0.14286
0,0,1,1,3,22,22,0.85714
480,0,1,1,3,468,468,0.85714
240,-16,0,0,2,222,238,0.28571
840,0,1,1,3,880,880,0.85714
240,0,1,1,3,229,229,0.85714
480,-7,0,0,3,457,464,0.14286
480,-17,0,0,2,478,495,0.28571
240,0,1,1,3,220,220,0.85714
480,0,1,1,3,471,471,0.85714
240,0,1,1,4,222,222,1
480,47,0,0,3,514,467,0.14286
480,0,1,1,3,494,494,0.85714
240,0,1,1,4,232,232,1
0,57,0,0,4,27,-30,0
840,39,0,0,3,898,859,0.14286
480,46,0,0,3,523,477,0.14286
240,0,1,1,3,262,262,0.85714
240,0,1,0,2,293,293,0.28571
240,0,1,0,3,225,225,0.14286
240,0,1,0,3,267,267,0.14286
0,47,0,0,3,20,-27,0.14286
840,0,1,1,3,848,848,0.85714
240,0,1,0,3,223,223,0.14286
0,0,1,0,3,0,0,0.14286
240,15,0,0,2,233,218,0.28571
0,0,1,0,3,32,32,0.14286
480,23,0,1,3,496,473,0.85714
840,31,0,1,3,848,817,0.85714
480,0,1,0,2,464,464,0.28571
480,35,0,1,3,514,479,0.85714
0,20,0,0,3,17,-3,0.14286
240,33,0,0,3,254,221,0.14286
0,28,0,0,4,6,-22,0
240,0,1,0,3,231,231,0.14286
480,31,0,0,2,519,488,0.28571
480,50,0,0,4,497,447,0
0,7,0,0,2,11,4,0.28571
0,40,0,0,3,63,23,0.14286
240,0,1,0,3,266,266,0.14286
0,0,1,1,1,14,14,0.57143
480,0,1,1,1,495,495,0.57143
0,0,1,1,2,19,19,0.71429
480,41,0,0,2,496,455,0.28571
840,0,1,1,3,852,852,0.85714
840,-32,0,0,3,844,876,0.14286
840,-14,0,1,2,845,859,0.71429
480,33,0,1,2,532,499,0.71429
0,23,0,0,2,22,-1,0.28571
240,-15,0,1,3,244,259,0.85714
240,0,1,1,4,235,235,1
840,0,1,1,2,851,851,0.71429
840,0,1,1,2,817,817,0.71429
0,0,1,1,3,1,1,0.85714
240,0,1,1,4,220,220,1
0,0,1,1,4,13,13,1
0,0,1,1,3,29,29,0.85714
240,0,1,1,3,234,234,0.85714
240,-35,0,0,2,253,288,0.28571
840,0,1,1,2,819,819,0.71429
0,0,1,1,4,37,37,1
840,63,0,0,3,849,786,0.14286
840,0,1,1,3,874,874,0.85714
240,6,0,1,2,266,260,0.71429
840,-11,0,1,1,836,847,0.57143
0,0,1,1,3,29,29,0.85714
480,-57,0,0,3,446,503,0.14286
840,-21,0,1,3,821,842,0.85714
240,11,0,0,2,244,233,0.28571
240,-8,0,1,3,242,250,0.85714
0,18,0,0,3,11,-7,0.14286
0,36,0,0,4,17,-19,0
480,0,1,1,3,480,480,0.85714
0,0,1,0,2,7,7,0.28571
840,0,1,1,3,825,825,0.85714
0,-34,0,0,3,-18,16,0.14286
480,-15,0,0,4,471,486,0
240,0,1,1,3,237,237,0.85714
840,-22,0,1,4,819,841,1
840,0,1,1,3,823,823,0.85714
0,0,1,1,4,10,10,1
840,0,1,1,4,862,862,1
0,10,0,1,1,20,10,0.57143
240,0,1,1,2,206,206,0.71429
840,0,1,1,3,788,788,0.85714
0,0,1,1,3,27,27,0.85714
240,0,1,0,3,271,271,0.14286
480,0,1,0,3,513,513,0.14286
840,-10,0,1,3,837,847,0.85714
840,0,1,0,3,846,846,0.14286
480,0,1,0,3,492,492,0.14286
480,-8,0,1,2,492,500,0.71429
240,38,0,0,2,243,205,0.28571
240,10,0,0,1,244,234,0.42857
240,0,1,0,3,276,276,0.14286
480,0,1,1,3,481,481,0.85714
0,-11,0,0,2,7,18,0.28571
840,0,1,1,3,826,826,0.85714
240,0,1,1,4,273,273,1
480,-12,0,1,4,469,481,1
840,0,1,1,4,835,835,1
480,-14,0,1,3,444,458,0.85714
480,-1,0,1,4,465,466,1
480,-2,0,1,4,474,476,1
240,0,1,1,3,205,205,0.85714
480,0,1,1,4,489,489,1
840,0,1,1,3,839,839,0.85714
0,-79,0,0,4,-16,63,0
0,50,0,0,4,43,-7,0
240,0,1,0,3,245,245,0.14286
480,0,1,1,3,456,456,0.85714
480,0,1,1,1,473,473,0.57143
240,11,0,0,2,246,235,0.28571
480,0,1,1,3,493,493,0.85714
0,0,1,1,3,-52,-52,0.85714
240,0,1,1,4,194,194,1
480,49,0,0,3,531,482,0.14286
0,34,0,0,3,-19,-53,0.14286
480,0,1,1,4,499,499,1
240,0,1,1,3,241,241,0.85714
240,-26,0,0,2,232,258,0.28571
240,-34,0,0,3,226,260,0.14286
0,0,1,0,2,-21,-21,0.28571
840,18,0,1,3,876,858,0.85714
480,-25,0,1,1,495,520,0.57143
240,4,0,1,2,236,232,0.71429
240,0,1,1,1,252,252,0.57143
840,41,0,0,2,878,837,0.28571
480,0,1,1,3,486,486,0.85714
240,-35,0,0,1,226,261,0.42857
0,-34,0,0,3,-24,10,0.14286
0,-17,0,0,2,-25,-8,0.28571
0,-23,0,0,3,4,27,0.14286
240,-6,0,1,3,230,236,0.85714
840,0,1,1,3,828,828,0.85714
840,0,1,1,1,841,841,0.57143
480,0,1,1,2,493,493,0.71429
480,0,1,1,2,514,514,0.71429
0,50,0,0,3,31,-19,0.14286
240,0,1,1,2,231,231,0.71429
240,0,1,1,3,251,251,0.85714
480,-35,0,1,2,441,476,0.71429
0,92,0,0,4,64,-28,0
840,0,1,1,3,818,818,0.85714
840,34,0,0,1,863,829,0.42857
0,0,1,1,3,-22,-22,0.85714
240,0,1,1,3,238,238,0.85714
840,-11,0,1,2,828,839,0.71429
0,0,1,1,4,-28,-28,1
480,0,1,0,2,494,494,0.28571
240,0,1,1,4,240,240,1
240,27,0,0,1,269,242,0.42857
240,22,0,0,2,209,187,0.28571
480,-4,0,0,3,482,486,0.14286
840,0,1,1,4,814,814,1
240,26,0,0,2,247,221,0.28571
240,19,0,0,3,249,230,0.14286
480,0,1,1,2,437,437,0.71429
0,-35,0,0,3,-7,28,0.14286
240,0,1,0,2,256,256,0.28571
480,8,0,1,3,458,450,0.85714
840,0,1,1,3,798,798,0.85714
480,5,0,1,2,471,466,0.71429
240,-1,0,1,3,224,225,0.85714
840,0,1,1,3,856,856,0.85714
240,17,0,1,2,233,216,0.71429
840,-11,0,1,3,808,819,0.85714
480,0,1,1,4,466,466,1
840,24,0,1,2,832,808,0.71429
840,0,1,1,3,823,823,0.85714
0,-76,0,0,4,9,85,0
240,-2,0,1,3,247,249,0.85714
0,11,0,1,2,29,18,0.71429
840,0,1,1,2,867,867,0.71429
480,0,1,1,3,469,469,0.85714
840,14,0,1,3,846,832,0.85714
240,0,1,1,3,262,262,0.85714
240,-10,0,1,4,243,253,1
840,0,1,1,3,832,832,0.85714
240,0,1,1,2,255,255,0.71429
240,0,1,1,3,261,261,0.85714
840,55,0,1,3,859,804,0.85714
480,0,1,1,2,497,497,0.71429
240,0,1,1,3,291,291,0.85714
840,-36,0,1,4,834,870,1
0,0,1,1,3,-47,-47,0.85714
840,-15,0,0,3,826,841,0.14286
240,10,0,1,4,241,231,1
840,-6,0,1,3,824,830,0.85714
840,8,0,0,3,847,839,0.14286
240,0,1,1,3,209,209,0.85714
0,0,1,1,4,-30,-30,1
240,0,1,1,4,216,216,1
0,20,0,0,1,23,3,0.42857
840,5,0,1,3,841,836,0.85714
480,0,1,1,3,493,493,0.85714
840,34,0,0,1,888,854,0.42857
240,8,0,0,2,214,206,0.28571
240,-4,0,1,3,228,232,0.85714
240,15,0,0,2,233,218,0.28571
0,19,0,0,2,-39,-58,0.28571
840,9,0,1,3,852,843,0.85714
0,0,1,1,3,11,11,0.85714
840,-11,0,1,4,840,851,1
840,-103,0,0,4,787,890,0
840,-3,0,0,2,826,829,0.28571
0,0,1,1,3,32,32,0.85714
840,-43,0,0,1,828,871,0.42857
480,8,0,1,3,474,466,0.85714
240,0,1,1,4,271,271,1
0,0,1,1,3,-16,-16,0.85714
240,0,1,1,3,260,260,0.85714
480,0,1,1,2,454,454,0.71429
240,0,1,1,3,218,218,0.85714
0,9,0,1,1,-3,-12,0.57143
840,-69,0,0,2,800,869,0.28571
840,-11,0,1,1,833,844,0.57143
480,0,1,1,2,490,490,0.71429
0,0,1,1,3,-12,-12,0.85714
840,-51,0,0,3,814,865,0.14286
0,0,1,1,4,3,3,1
840,0,1,0,2,877,877,0.28571
480,0,1,1,2,475,475,0.71429
240,0,1,1,4,233,233,1
0,53,0,0,4,44,-9,0
840,0,1,0,3,813,813,0.14286
240,0,1,0,2,206,206,0.28571
0,0,1,1,4,-5,-5,1
840,4,0,1,4,823,819,1
480,0,1,1,3,527,527,0.85714
240,-17,0,1,2,229,246,0.71429
240,0,1,1,3,253,253,0.85714
480,0,1,1,3,452,452,0.85714
240,0,1,1,4,262,262,1
240,-8,0,1,3,238,246,0.85714
840,51,0,0,2,882,831,0.28571
480,24,0,0,2,514,490,0.28571
480,0,1,1,1,509,509,0.57143
0,-17,0,0,2,12,29,0.28571
840,0,1,1,4,838,838,1
240,0,1,1,4,208,208,1
480,0,1,1,3,484,484,0.85714
240,0,1,0,3,226,226,0.14286
480,37,0,0,2,489,452,0.28571
840,3,0,1,3,866,863,0.85714
480,0,1,1,4,512,512,1
240,-7,0,1,4,198,205,1
840,-74,0,0,3,811,885,0.14286
480,-24,0,0,2,472,496,0.28571
240,5,0,1,4,244,239,1
480,0,1,0,1,472,472,0.42857
840,0,1,1,2,834,834,0.71429
480,3,0,1,3,470,467,0.85714
0,0,1,1,3,-9,-9,0.85714
840,0,1,1,2,806,806,0.71429
0,0,1,1,3,-21,-21,0.85714
480,0,1,0,2,522,522,0.28571
480,0,1,1,3,483,483,0.85714
840,0,1,1,3,852,852,0.85714
0,0,1,0,3,45,45,0.14286
0,12,0,0,2,12,0,0.28571
480,-28,0,0,2,461,489,0.28571
840,0,1,1,3,865,865,0.85714
840,0,1,1,3,884,884,0.85714
240,0,1,1,4,306,306,1
840,0,1,1,3,852,852,0.85714
0,0,1,1,4,5,5,1
480,-20,0,0,2,461,481,0.28571
240,0,1,0,2,291,291,0.28571
0,0,1,1,4,-6,-6,1
480,-43,0,0,2,485,528,0.28571
480,0,1,1,4,467,467,1
0,0,1,1,4,39,39,1
0,2,0,1,4,-15,-17,1
480,11,0,1,3,472,461,0.85714
840,-37,0,0,2,825,862,0.28571
0,0,1,1,3,-32,-32,0.85714
480,-25,0,0,2,493,518,0.28571
0,0,1,1,4,10,10,1
0,0,1,1,3,82,82,0.85714
240,0,1,1,4,242,242,1
840,0,1,0,2,822,822,0.28571
240,-41,0,0,2,260,301,0.28571
480,0,1,1,3,486,486,0.85714
240,0,1,1,3,245,245,0.85714
840,0,1,1,3,826,826,0.85714
0,0,1,1,3,-62,-62,0.85714
240,-35,0,0,2,224,259,0.28571
840,9,0,1,3,849,840,0.85714
480,0,1,1,3,470,470,0.85714
480,0,1,1,4,490,490,1
480,-30,0,0,2,465,495,0.28571
0,51,0,0,3,4,-47,0.14286
840,-31,0,0,2,851,882,0.28571
0,0,1,0,2,-15,-15,0.28571
840,0,1,1,3,833,833,0.85714
0,0,1,1,4,-33,-33,1
480,0,1,1,4,462,462,1
480,0,1,1,4,488,488,1
840,0,1,1,4,812,812,1
240,0,1,1,4,229,229,1
0,0,1,1,4,-19,-19,1
840,15,0,1,3,870,855,0.85714
240,46,0,0,3,255,209,0.14286
840,-16,0,0,4,845,861,0
0,4,0,1,4,9,5,1
840,-23,0,1,3,828,851,0.85714
480,0,1,1,3,449,449,0.85714
840,37,0,1,3,855,818,0.85714
480,0,1,1,3,518,518,0.85714
840,0,1,0,1,825,825,0.42857
240,0,1,1,4,242,242,1
480,0,1,1,4,471,471,1
480,0,1,1,3,479,479,0.85714
0,0,1,1,3,13,13,0.85714
0,0,1,1,3,-17,-17,0.85714
840,0,1,1,4,815,815,1
0,2,0,0,3,26,24,0.14286
840,-24,0,1,2,819,843,0.71429
0,-5,0,1,3,-28,-23,0.85714
0,14,0,1,3,-33,-47,0.85714
0,-13,0,0,1,-2,11,0.42857
0,-4,0,1,1,-25,-21,0.57143
240,28,0,0,2,262,234,0.28571
480,0,1,0,2,484,484,0.28571
0,-13,0,0,2,3,16,0.28571
0,-3,0,1,3,-8,-5,0.85714
0,10,0,0,1,12,2,0.42857
0,0,1,1,3,15,15,0.85714
0,20,0,0,3,11,-9,0.14286
240,0,1,0,2,257,257,0.28571
0,0,1,1,4,42,42,1
480,0,1,0,1,501,501,0.42857
840,26,0,1,2,844,818,0.71429
0,0,1,1,4,-50,-50,1
240,0,1,1,2,237,237,0.71429
480,22,0,1,1,490,468,0.57143
240,10,0,0,1,281,271,0.42857
0,3,0,1,2,7,4,0.71429
480,61,0,0,4,505,444,0
840,15,0,0,1,860,845,0.42857
240,57,0,0,4,276,219,0
480,0,1,1,1,441,441,0.57143
0,26,0,0,4,10,-16,0
480,0,1,0,2,466,466,0.28571
480,24,0,0,2,482,458,0.28571
480,-74,0,0,3,441,515,0.14286
480,0,1,1,4,526,526,1
480,43,0,0,2,499,456,0.28571
840,-49,0,0,3,848,897,0.14286
240,-5,0,1,3,240,245,0.85714
480,79,0,0,2,518,439,0.28571
480,0,1,1,3,465,465,0.85714
240,0,1,1,3,234,234,0.85714
240,27,0,1,3,263,236,0.85714
0,-23,0,0,3,-10,13,0.14286
0,0,1,1,3,7,7,0.85714
840,34,0,0,3,847,813,0.14286
0,-25,0,0,3,-10,15,0.14286
840,6,0,0,3,850,844,0.14286
840,0,1,0,1,853,853,0.42857
480,0,1,1,3,493,493,0.85714
840,-51,0,1,2,844,895,0.71429
480,-15,0,1,4,424,439,1
480,-53,0,0,3,441,494,0.14286
480,42,0,1,3,499,457,0.85714
480,0,1,1,4,520,520,1
240,-28,0,0,3,232,260,0.14286
0,0,1,1,4,1,1,1
480,0,1,1,3,436,436,0.85714
240,0,1,1,3,204,204,0.85714
0,-14,0,0,3,-7,7,0.14286
840,9,0,1,4,868,859,1
240,7,0,1,3,253,246,0.85714
0,0,1,1,4,25,25,1
240,41,0,0,3,239,198,0.14286
0,21,0,0,2,-5,-26,0.28571
240,16,0,0,1,235,219,0.42857
480,73,0,0,3,546,473,0.14286
0,-77,0,0,4,-44,33,0
0,0,1,1,3,31,31,0.85714
0,19,0,0,3,10,-9,0.14286
480,92,0,0,3,512,420,0.14286
840,14,0,1,2,828,814,0.71429
480,-89,0,0,3,406,495,0.14286
840,0,1,1,4,791,791,1
480,0,1,1,3,457,457,0.85714
840,0,1,1,4,843,843,1
0,0,1,1,4,8,8,1
840,-37,0,1,1,816,853,0.57143
840,0,1,1,3,868,868,0.85714
240,0,1,1,4,188,188,1
240,-21,0,1,2,205,226,0.71429
480,-10,0,1,3,473,483,0.85714
240,38,0,0,3,259,221,0.14286
480,-50,0,0,3,497,547,0.14286
240,-41,0,0,3,238,279,0.14286
840,-6,0,1,2,859,865,0.71429
0,0,1,1,3,11,11,0.85714
480,63,0,0,2,537,474,0.28571
840,-25,0,0,3,817,842,0.14286
840,0,1,0,2,886,886,0.28571
240,0,1,1,3,202,202,0.85714
480,-36,0,1,4,457,493,1
840,29,0,1,3,880,851,0.85714
840,0,1,1,3,830,830,0.85714
840,0,1,1,4,805,805,1
0,45,0,0,3,16,-29,0.14286
240,0,1,0,1,234,234,0.42857
840,0,1,1,3,866,866,0.85714
240,0,1,1,3,233,233,0.85714
840,0,1,1,4,855,855,1
0,0,1,1,3,-30,-30,0.85714
0,0,1,1,3,-32,-32,0.85714
480,0,1,1,3,486,486,0.85714
240,-1,0,0,2,234,235,0.28571
840,0,1,1,3,852,852,0.85714
240,-1,0,1,3,229,230,0.85714
480,0,1,1,4,485,485,1
840,-19,0,1,3,831,850,0.85714
240,0,1,1,3,239,239,0.85714
480,56,0,1,3,508,452,0.85714
840,-21,0,1,4,808,829,1
240,0,1,1,3,250,250,0.85714
840,-15,0,1,4,857,872,1
480,0,1,1,3,478,478,0.85714
840,0,1,1,2,817,817,0.71429
0,-22,0,0,3,-29,-7,0.14286
840,30,0,1,4,847,817,1
0,-30,0,0,3,-13,17,0.14286
480,23,0,1,3,480,457,0.85714
480,0,1,1,3,498,498,0.85714
240,-2,0,1,3,220,222,0.85714
480,0,1,1,3,460,460,0.85714
840,20,0,1,3,854,834,0.85714
480,0,1,1,2,450,450,0.71429
240,-38,0,0,2,206,244,0.28571
840,-23,0,1,3,844,867,0.85714
0,-10,0,0,1,-0,10,0.42857
480,0,1,1,3,466,466,0.85714
240,-55,0,0,3,217,272,0.14286
240,14,0,0,2,239,225,0.28571
0,0,1,1,3,-13,-13,0.85714
840,11,0,0,1,860,849,0.42857
840,0,1,1,2,859,859,0.71429
0,-24,0,0,3,-14,10,0.14286
0,12,0,0,1,18,6,0.42857
840,1,0,1,2,835,834,0.71429
0,-45,0,0,3,-16,29,0.14286
240,0,1,1,2,233,233,0.71429
240,50,0,0,3,253,203,0.14286
480,0,1,1,3,488,488,0.85714
240,0,1,1,2,247,247,0.71429
840,-46,0,0,3,822,868,0.14286
240,3,0,1,2,266,263,0.71429
240,0,1,1,3,256,256,0.85714
840,0,1,1,1,828,828,0.57143
0,38,0,0,4,9,-29,0
240,-33,0,0,1,251,284,0.42857
480,0,1,1,3,460,460,0.85714
0,-3,0,1,2,-12,-9,0.71429
0,0,1,1,1,34,34,0.57143
840,0,1,1,2,839,839,0.71429
240,-5,0,1,3,203,208,0.85714
480,-28,0,1,3,518,546,0.85714
0,-3,0,1,4,10,13,1
480,-4,0,1,4,441,445,1
480,0,1,1,3,505,505,0.85714
840,0,1,0,3,841,841,0.14286
240,-28,0,0,2,211,239,0.28571
840,0,1,0,3,842,842,0.14286
240,0,1,1,4,253,253,1
840,-20,0,1,2,821,841,0.71429
0,-9,0,1,1,8,17,0.57143
240,0,1,1,3,232,232,0.85714
480,85,0,0,4,537,452,0
480,0,1,1,4,509,509,1
480,39,0,0,3,490,451,0.14286
0,0,1,1,4,2,2,1
0,0,1,1,4,-10,-10,1
0,-29,0,0,4,-38,-9,0
480,0,1,1,3,441,441,0.85714
480,18,0,1,2,480,462,0.71429
840,0,1,1,4,845,845,1
840,0,1,1,2,828,828,0.71429
480,-46,0,0,2,432,478,0.28571
240,-1,0,1,3,243,244,0.85714
840,0,1,0,3,856,856,0.14286
240,56,0,0,3,286,230,0.14286
840,0,1,1,4,823,823,1
480,0,1,1,3,502,502,0.85714
240,0,1,0,3,261,261,0.14286
480,67,0,0,3,518,451,0.14286
480,-40,0,0,3,426,466,0.14286
0,-18,0,0,4,-17,1,0
480,0,1,1,4,488,488,1
0,-38,0,0,3,-19,19,0.14286
480,0,1,1,3,482,482,0.85714
240,0,1,0,4,228,228,0
840,0,1,1,4,887,887,1
480,1,0,1,3,476,475,0.85714
0,0,1,1,3,-6,-6,0.85714
840,-86,0,0,3,825,911,0.14286
840,3,0,1,3,844,841,0.85714
840,0,1,1,3,823,823,0.85714
240,0,1,1,4,253,253,1
0,0,1,1,4,-24,-24,1
0,0,1,1,1,-7,-7,0.57143
0,0,1,1,4,7,7,1
840,0,1,1,2,833,833,0.71429
240,0,1,1,3,229,229,0.85714
0,-12,0,0,1,-35,-23,0.42857
480,-74,0,0,2,440,514,0.28571
240,0,1,1,2,244,244,0.71429
0,0,1,1,4,-16,-16,1
840,-19,0,1,2,825,844,0.71429
480,19,0,0,1,489,470,0.42857
480,11,0,1,3,484,473,0.85714
240,-11,0,1,3,230,241,0.85714
840,0,1,0,2,833,833,0.28571
480,0,1,1,4,485,485,1
480,0,1,1,4,511,511,1
480,-2,0,0,1,485,487,0.42857
480,0,1,1,3,445,445,0.85714
0,-17,0,0,4,2,19,0
840,6,0,1,1,830,824,0.57143
840,-11,0,1,2,836,847,0.71429
480,4,0,1,2,499,495,0.71429
480,0,1,1,3,494,494,0.85714
0,10,0,0,2,1,-9,0.28571
240,0,1,0,2,243,243,0.28571
480,-30,0,1,4,439,469,1
0,0,1,1,4,8,8,1
840,29,0,1,1,876,847,0.57143
840,-10,0,1,4,834,844,1
240,0,1,0,2,246,246,0.28571
480,29,0,0,3,480,451,0.14286
240,38,0,0,4,283,245,0
0,-11,0,0,4,-21,-10,0
840,-5,0,1,1,832,837,0.57143
240,0,1,0,2,269,269,0.28571
0,0,1,1,4,15,15,1
240,27,0,0,3,267,240,0.14286
240,-30,0,0,2,188,218,0.28571
480,11,0,1,1,470,459,0.57143
240,0,1,1,2,234,234,0.71429
480,-23,0,0,2,497,520,0.28571
840,0,1,1,2,866,866,0.71429
480,0,1,1,3,468,468,0.85714
0,2,0,1,3,10,8,0.85714
840,0,1,1,4,833,833,1
0,0,1,1,4,20,20,1
480,0,1,1,3,466,466,0.85714
240,15,0,0,2,230,215,0.28571
240,8,0,0,2,201,193,0.28571
240,-3,0,0,2,253,256,0.28571
0,0,1,0,3,-18,-18,0.14286
240,0,1,1,1,246,246,0.57143
840,0,1,0,3,858,858,0.14286
0,0,1,1,3,-39,-39,0.85714
480,-57,0,0,3,433,490,0.14286
240,-7,0,1,4,259,266,1
840,0,1,1,3,829,829,0.85714
240,22,0,0,2,242,220,0.28571
480,11,0,0,2,454,443,0.28571
480,-50,0,0,3,472,522,0.14286
480,0,1,1,4,466,466,1
0,30,0,1,2,9,-21,0.71429
840,-6,0,0,3,857,863,0.14286
0,0,1,0,2,-4,-4,0.28571
240,10,0,1,3,239,229,0.85714
840,0,1,0,2,819,819,0.28571
840,43,0,0,3,865,822,0.14286
840,0,1,0,3,859,859,0.14286
480,38,0,1,4,499,461,1
840,0,1,1,2,828,828,0.71429
240,0,1,1,2,244,244,0.71429
840,0,1,0,2,883,883,0.28571
840,0,1,0,3,827,827,0.14286
480,8,0,1,3,501,493,0.85714
240,0,1,0,1,269,269,0.42857
840,17,0,0,2,864,847,0.28571
0,0,1,1,4,13,13,1
840,0,1,1,4,845,845,1
480,-4,0,1,4,493,497,1
480,0,1,1,3,493,493,0.85714
0,-4,0,1,3,-10,-6,0.85714
240,0,1,0,4,247,247,0
0,-14,0,1,3,-3,11,0.85714
240,-9,0,1,4,218,227,1
840,0,1,1,2,867,867,0.71429
840,0,1,1,2,843,843,0.71429
840,0,1,1,3,833,833,0.85714
240,47,0,0,4,245,198,0
480,0,1,0,2,455,455,0.28571
0,-25,0,0,3,13,38,0.14286
0,0,1,1,4,-20,-20,1
480,-21,0,0,2,473,494,0.28571
480,0,1,0,2,495,495,0.28571
480,59,0,0,3,546,487,0.14286
240,0,1,0,3,225,225,0.14286
480,-37,0,0,3,452,489,0.14286
480,0,1,1,4,470,470,1
0,-32,0,0,4,-38,-6,0
480,0,1,0,3,492,492,0.14286
240,-20,0,0,3,277,297,0.14286
240,0,1,0,2,268,268,0.28571
0,0,1,1,3,16,16,0.85714
240,-55,0,0,3,231,286,0.14286
840,0,1,1,4,835,835,1
840,-35,0,1,4,812,847,1
840,0,1,1,3,847,847,0.85714
240,0,1,1,2,226,226,0.71429
240,-25,0,1,4,212,237,1
840,3,0,1,3,808,805,0.85714
240,0,1,1,4,217,217,1
840,0,1,1,3,834,834,0.85714
240,14,0,0,3,224,210,0.14286
240,9,0,0,2,253,244,0.28571
0,14,0,0,3,3,-11,0.14286
480,0,1,1,3,461,461,0.85714
240,0,1,0,3,266,266,0.14286
840,0,1,1,4,811,811,1
480,0,1,1,3,496,496,0.85714
0,21,0,0,4,-2,-23,0
840,0,1,0,3,805,805,0.14286
480,0,1,1,4,461,461,1
0,0,1,1,4,14,14,1
0,39,0,0,3,0,-39,0.14286
480,0,1,1,3,514,514,0.85714
0,30,0,0,4,-14,-44,0
0,50,0,0,4,10,-40,0
0,0,1,1,3,34,34,0.85714
240,0,1,0,2,228,228,0.28571
840,50,0,0,2,866,816,0.28571
840,16,0,0,1,861,845,0.42857
240,87,0,1,3,287,200,0.85714
0,0,1,0,2,-19,-19,0.28571
0,30,0,0,4,46,16,0
480,5,0,0,2,487,482,0.28571
840,0,1,0,4,843,843,0
0,27,0,0,3,-9,-36,0.14286
0,17,0,0,3,-4,-21,0.14286
240,0,1,0,2,249,249,0.28571
480,0,1,0,3,532,532,0.14286
0,0,1,0,3,16,16,0.14286
0,0,1,0,1,8,8,0.42857
480,12,0,1,3,470,458,0.85714
480,0,1,1,3,491,491,0.85714
480,0,1,0,2,470,470,0.28571
480,-10,0,0,3,446,456,0.14286
840,-8,0,1,2,828,836,0.71429
0,-14,0,0,2,25,39,0.28571
0,16,0,0,2,-5,-21,0.28571
840,22,0,1,3,873,851,0.85714
480,33,0,0,2,481,448,0.28571
240,-12,0,0,2,250,262,0.28571
240,0,1,0,2,243,243,0.28571
0,0,1,1,4,0,0,1
480,0,1,1,4,476,476,1
240,0,1,1,4,214,214,1
0,0,1,1,4,5,5,1
840,0,1,0,2,818,818,0.28571
0,-67,0,0,4,-21,46,0
480,-18,0,0,3,456,474,0.14286
240,0,1,0,3,241,241,0.14286
240,0,1,1,3,241,241,0.85714
480,71,0,0,4,473,402,0
840,0,1,0,3,828,828,0.14286
480,-22,0,0,3,477,499,0.14286
0,-33,0,0,4,-23,10,0
480,0,1,1,3,490,490,0.85714
0,-8,0,0,3,1,9,0.14286
480,16,0,1,4,509,493,1
840,-7,0,1,4,806,813,1
480,20,0,1,1,485,465,0.57143
840,4,0,1,4,926,922,1
480,0,1,1,4,471,471,1
240,0,1,0,2,260,260,0.28571
480,-39,0,0,3,427,466,0.14286
0,0,1,0,1,12,12,0.42857
840,-25,0,0,1,826,851,0.42857
840,0,1,1,3,798,798,0.85714
240,0,1,0,2,260,260,0.28571
240,0,1,0,2,283,283,0.28571
0,18,0,0,3,-19,-37,0.14286
480,0,1,0,4,484,484,0
0,0,1,1,4,10,10,1
840,0,1,1,3,828,828,0.85714
840,0,1,0,2,851,851,0.28571
240,0,1,0,3,311,311,0.14286
240,-50,0,0,3,217,267,0.14286
0,0,1,0,4,-11,-11,0
480,-20,0,1,4,455,475,1
480,17,0,1,3,490,473,0.85714
0,22,0,1,2,15,-7,0.71429
480,0,1,1,3,493,493,0.85714
840,0,1,0,3,837,837,0.14286
840,0,1,1,4,821,821,1
840,0,1,0,2,832,832,0.28571
0,-7,0,0,2,0,7,0.28571
840,0,1,1,3,806,806,0.85714
240,-45,0,1,4,226,271,1
840,0,1,1,4,807,807,1
840,-38,0,0,2,831,869,0.28571
480,-47,0,0,3,465,512,0.14286
0,0,1,1,4,0,0,1
0,0,1,1,3,4,4,0.85714
240,0,1,1,2,230,230,0.71429
240,-68,0,0,4,178,246,0
840,22,0,1,1,855,833,0.57143
0,0,1,1,2,-7,-7,0.71429
480,0,1,1,2,482,482,0.71429
840,0,1,1,3,805,805,0.85714
480,35,0,0,2,513,478,0.28571
480,0,1,1,4,466,466,1
0,0,1,1,3,33,33,0.85714
840,16,0,1,1,834,818,0.57143
0,36,0,0,4,13,-23,0
840,0,1,0,2,822,822,0.28571
0,0,1,1,3,-4,-4,0.85714
840,0,1,1,2,846,846,0.71429
0,0,1,1,3,21,21,0.85714
0,-31,0,0,3,15,46,0.14286
840,-51,0,0,3,816,867,0.14286
480,0,1,1,4,515,515,1
480,26,0,0,2,486,460,0.28571
240,-18,0,1,3,223,241,0.85714
480,0,1,1,2,492,492,0.71429
0,1,0,0,1,29,28,0.42857
840,0,1,1,3,835,835,0.85714
240,19,0,0,3,261,242,0.14286
480,0,1,1,3,475,475,0.85714
840,30,0,0,2,865,835,0.28571
840,-23,0,0,2,839,862,0.28571
0,-10,0,0,3,-19,-9,0.14286
0,-89,0,0,4,-49,40,0
0,-7,0,0,1,-20,-13,0.42857
840,-51,0,0,3,782,833,0.14286
840,0,1,1,3,850,850,0.85714
480,0,1,1,4,482,482,1
240,32,0,0,2,261,229,0.28571
480,0,1,0,1,452,452,0.42857
0,0,1,1,3,-11,-11,0.85714
240,10,0,0,2,233,223,0.28571
480,0,1,0,3,514,514,0.14286
480,0,1,1,4,468,468,1
0,-34,0,0,3,4,38,0.14286
840,3,0,1,3,865,862,0.85714
0,0,1,1,4,-31,-31,1
840,28,0,0,3,845,817,0.14286
0,0,1,1,4,-35,-35,1
240,0,1,0,2,229,229,0.28571
240,-17,0,0,1,246,263,0.42857
840,0,1,1,3,859,859,0.85714
240,0,1,0,2,224,224,0.28571
480,0,1,1,4,494,494,1
840,1,0,1,4,823,822,1
0,41,0,0,3,13,-28,0.14286
240,-68,0,0,3,223,291,0.14286
0,0,1,1,3,-27,-27,0.85714
0,0,1,1,3,22,22,0.85714
840,19,0,0,2,884,865,0.28571
840,19,0,0,3,891,872,0.14286
0,0,1,0,3,9,9,0.14286
240,-31,0,0,2,217,248,0.28571
480,64,0,0,3,500,436,0.14286
480,0,1,0,3,477,477,0.14286
240,26,0,0,4,260,234,0
240,-27,0,0,4,235,262,0
840,-27,0,1,4,838,865,1
480,22,0,0,3,452,430,0.14286
0,-24,0,0,4,-46,-22,0
0,0,1,0,4,-30,-30,0
480,37,0,0,3,497,460,0.14286
840,0,1,1,2,844,844,0.71429
240,-7,0,0,3,214,221,0.14286
480,-13,0,0,3,473,486,0.14286
240,42,0,0,4,274,232,0
840,0,1,0,2,852,852,0.28571
240,0,1,0,3,242,242,0.14286
480,11,0,0,3,546,535,0.14286
480,0,1,0,4,516,516,0
0,-2,0,0,3,-12,-10,0.14286
0,0,1,1,4,8,8,1
840,0,1,1,3,872,872,0.85714
0,24,0,0,3,42,18,0.14286
0,0,1,0,4,-8,-8,0
840,0,1,0,2,856,856,0.28571
480,-63,0,0,3,457,520,0.14286
480,0,1,0,4,455,455,0
240,-4,0,0,3,241,245,0.14286
240,64,0,0,4,251,187,0
240,-66,0,0,3,205,271,0.14286
240,0,1,0,2,248,248,0.28571
480,0,1,1,4,467,467,1
480,0,1,1,3,490,490,0.85714
240,0,1,0,2,270,270,0.28571
840,26,0,0,1,852,826,0.42857
240,0,1,0,3,221,221,0.14286
840,0,1,0,3,811,811,0.14286
480,22,0,0,2,490,468,0.28571
240,10,0,1,2,252,242,0.71429
840,-5,0,1,3,888,893,0.85714
480,12,0,1,2,465,453,0.71429
0,13,0,0,2,19,6,0.28571
840,33,0,0,2,839,806,0.28571
480,0,1,0,1,504,504,0.42857
840,-1,0,0,1,839,840,0.42857
480,-19,0,0,3,438,457,0.14286
0,-42,0,0,3,-30,12,0.14286
240,0,1,1,2,223,223,0.71429
840,-12,0,0,3,844,856,0.14286
240,16,0,0,2,244,228,0.28571
240,0,1,1,3,259,259,0.85714
240,0,1,1,2,251,251,0.71429
240,0,1,0,2,231,231,0.28571
840,0,1,0,3,814,814,0.14286
840,16,0,0,2,801,785,0.28571
480,-2,0,0,3,473,475,0.14286
480,-7,0,1,4,454,461,1
240,0,1,1,3,217,217,0.85714
840,0,1,1,3,838,838,0.85714
240,-8,0,0,2,247,255,0.28571
480,0,1,1,4,511,511,1
0,0,1,1,3,7,7,0.85714
0,0,1,1,2,-10,-10,0.71429
480,0,1,1,4,521,521,1
240,53,0,0,3,274,221,0.14286
840,0,1,1,4,836,836,1
480,0,1,1,3,479,479,0.85714
240,0,1,0,2,263,263,0.28571
0,10,0,0,3,19,9,0.14286
480,0,1,0,2,499,499,0.28571
480,-41,0,0,1,452,493,0.42857
0,0,1,0,1,30,30,0.42857
240,0,1,1,3,230,230,0.85714
0,0,1,1,3,-36,-36,0.85714
480,-84,0,0,4,433,517,0
840,0,1,1,3,819,819,0.85714
480,45,0,0,2,481,436,0.28571
480,-37,0,0,3,437,474,0.14286
480,0,1,1,3,499,499,0.85714
840,0,1,1,4,831,831,1
840,0,1,0,3,814,814,0.14286
240,-53,0,0,4,216,269,0
480,0,1,1,3,482,482,0.85714
480,0,1,1,4,472,472,1
480,6,0,0,4,498,492,0
840,28,0,1,3,853,825,0.85714
480,-27,0,0,3,466,493,0.14286
0,0,1,1,4,14,14,1
240,-20,0,0,2,247,267,0.28571
240,-7,0,0,3,233,240,0.14286
480,1,0,1,2,490,489,0.71429
240,0,1,0,3,253,253,0.14286
0,14,0,0,2,28,14,0.28571
240,0,1,0,3,239,239,0.14286
0,0,1,1,4,63,63,1
240,0,1,1,3,306,306,0.85714
240,0,1,1,4,232,232,1
480,0,1,1,4,488,488,1
840,0,1,1,2,849,849,0.71429
0,0,1,1,4,3,3,1
240,0,1,0,2,222,222,0.28571
480,0,1,1,4,466,466,1
480,56,0,0,3,512,456,0.14286
840,-18,0,1,4,808,826,1
240,0,1,1,3,208,208,0.85714
480,0,1,0,2,480,480,0.28571
480,0,1,1,4,481,481,1
0,0,1,1,4,-31,-31,1
0,0,1,1,3,39,39,0.85714
0,-10,0,0,2,29,39,0.28571
0,0,1,1,4,-34,-34,1
240,0,1,0,3,255,255,0.14286
240,-6,0,1,3,223,229,0.85714
480,0,1,1,4,484,484,1
480,0,1,0,2,516,516,0.28571
0,22,0,0,3,4,-18,0.14286
840,55,0,0,2,887,832,0.28571
240,9,0,1,3,235,226,0.85714
0,-37,0,0,3,-21,16,0.14286
240,0,1,1,4,231,231,1
480,-11,0,0,3,450,461,0.14286
480,0,1,1,4,458,458,1
240,0,1,0,2,242,242,0.28571
240,0,1,0,2,202,202,0.28571
240,0,1,0,2,246,246,0.28571
240,-4,0,0,3,261,265,0.14286
0,0,1,0,3,12,12,0.14286
480,0,1,1,4,480,480,1
840,0,1,1,3,874,874,0.85714
0,0,1,1,4,3,3,1
0,-26,0,0,3,-18,8,0.14286
480,-44,0,0,2,452,496,0.28571
840,20,0,1,4,882,862,1
840,0,1,1,3,835,835,0.85714
840,0,1,1,4,843,843,1
840,-11,0,0,3,832,843,0.14286
480,36,0,0,2,525,489,0.28571
480,-67,0,0,3,447,514,0.14286
240,0,1,1,3,267,267,0.85714
240,0,1,0,1,260,260,0.42857
840,0,1,1,3,840,840,0.85714
0,0,1,1,2,-17,-17,0.71429
0,0,1,1,3,-6,-6,0.85714
840,0,1,1,3,851,851,0.85714
240,22,0,0,3,250,228,0.14286
840,17,0,1,2,865,848,0.71429
240,-5,0,1,4,228,233,1
0,16,0,0,2,-23,-39,0.28571
840,0,1,0,2,882,882,0.28571
480,48,0,0,3,497,449,0.14286
0,0,1,1,3,16,16,0.85714
840,0,1,1,3,854,854,0.85714
0,0,1,1,4,-19,-19,1
480,0,1,1,4,441,441,1
240,0,1,1,3,184,184,0.85714
0,0,1,1,2,57,57,0.71429
840,0,1,1,4,803,803,1
0,3,0,1,1,-4,-7,0.57143
240,-17,0,0,2,191,208,0.28571
0,-25,0,0,3,-21,4,0.14286
0,36,0,0,3,17,-19,0.14286
0,-15,0,0,4,-24,-9,0
0,-11,0,1,1,-30,-19,0.57143
240,9,0,0,1,222,213,0.42857
240,0,1,0,2,290,290,0.28571
480,14,0,1,3,529,515,0.85714
0,-37,0,0,4,-14,23,0
240,23,0,0,2,242,219,0.28571
0,22,0,0,3,-9,-31,0.14286
240,0,1,1,4,232,232,1
480,2,0,1,4,470,468,1
840,0,1,1,3,832,832,0.85714
0,0,1,1,4,-16,-16,1
240,0,1,1,4,236,236,1
480,69,0,0,4,537,468,0
240,0,1,1,2,231,231,0.71429
480,0,1,1,4,502,502,1
840,35,0,1,1,834,799,0.57143
840,12,0,1,2,873,861,0.71429
240,4,0,1,2,238,234,0.71429
0,14,0,0,4,48,34,0
840,18,0,0,1,851,833,0.42857
240,0,1,0,2,214,214,0.28571
0,0,1,1,3,55,55,0.85714
240,56,0,0,4,244,188,0
240,0,1,0,1,278,278,0.42857
0,17,0,0,3,15,-2,0.14286
240,-30,0,0,2,239,269,0.28571
480,0,1,1,3,479,479,0.85714
840,51,0,0,4,884,833,0
240,-9,0,0,2,224,233,0.28571
0,-3,0,0,3,-14,-11,0.14286
480,1,0,0,3,475,474,0.14286
0,0,1,0,4,-23,-23,0
240,0,1,0,2,225,225,0.28571
840,21,0,1,3,863,842,0.85714
840,-21,0,1,2,845,866,0.71429
480,0,1,1,3,456,456,0.85714
0,68,0,0,4,20,-48,0
240,-14,0,0,3,223,237,0.14286
240,0,1,0,2,251,251,0.28571
840,0,1,0,3,817,817,0.14286
480,-1,0,1,4,511,512,1
840,-10,0,1,4,840,850,1
240,13,0,0,3,219,206,0.14286
0,0,1,1,4,12,12,1
840,0,1,1,3,841,841,0.85714
0,0,1,1,4,-44,-44,1
240,52,0,0,3,259,207,0.14286
0,0,1,1,4,-13,-13,1
840,-5,0,1,4,830,835,1
0,51,0,0,4,28,-23,0
0,0,1,1,4,-26,-26,1
840,18,0,1,3,862,844,0.85714
480,9,0,0,3,484,475,0.14286
0,47,0,0,4,48,1,0
480,9,0,0,2,478,469,0.28571
240,-15,0,1,4,218,233,1
480,0,1,0,3,458,458,0.14286
0,15,0,0,2,13,-2,0.28571
840,39,0,0,2,840,801,0.28571
0,17,0,0,3,-29,-46,0.14286
0,-14,0,0,2,1,15,0.28571
0,0,1,1,4,64,64,1
0,0,1,1,4,-14,-14,1
240,0,1,0,3,259,259,0.14286
480,0,1,1,4,490,490,1
840,0,1,1,4,869,869,1
0,-10,0,1,3,1,11,0.85714
840,-2,0,0,3,853,855,0.14286
840,-57,0,0,4,815,872,0
0,2,0,1,4,12,10,1
0,-22,0,0,3,-16,6,0.14286
240,-12,0,0,2,238,250,0.28571
240,-5,0,1,4,226,231,1
480,0,1,1,3,457,457,0.85714
480,3,0,1,4,468,465,1
240,0,1,1,4,252,252,1
480,0,1,0,3,451,451,0.14286
480,-32,0,0,3,479,511,0.14286
240,14,0,0,4,239,225,0
480,0,1,1,3,485,485,0.85714
240,0,1,0,4,226,226,0
840,7,0,0,4,818,811,0
240,35,0,0,4,291,256,0
0,0,1,1,4,38,38,1
480,0,1,1,4,511,511,1
0,0,1,1,4,20,20,1
480,0,1,1,4,490,490,1
240,0,1,1,3,260,260,0.85714
0,-16,0,1,4,-20,-4,1
480,0,1,1,4,473,473,1
480,-51,0,0,3,487,538,0.14286
240,0,1,0,4,257,257,0
480,-22,0,0,3,489,511,0.14286
480,0,1,1,3,470,470,0.85714
840,-56,0,0,2,780,836,0.28571
0,0,1,1,4,44,44,1
840,93,0,0,3,901,808,0.14286
0,0,1,1,4,20,20,1
840,-24,0,1,4,832,856,1
840,0,1,1,3,860,860,0.85714
480,-6,0,0,2,468,474,0.28571
240,0,1,1,4,218,218,1
840,0,1,1,4,766,766,1
240,-16,0,1,2,234,250,0.71429
240,12,0,1,1,262,250,0.57143
480,-11,0,0,2,460,471,0.28571
0,19,0,0,3,11,-8,0.14286
840,0,1,1,3,832,832,0.85714
840,-59,0,0,3,827,886,0.14286
240,0,1,0,2,233,233,0.28571
480,36,0,1,3,502,466,0.85714
840,0,1,1,4,818,818,1
0,-28,0,0,2,-18,10,0.28571
840,-30,0,0,3,855,885,0.14286
240,0,1,1,3,248,248,0.85714
480,-2,0,1,2,477,479,0.71429
840,38,0,0,2,858,820,0.28571
480,44,0,0,1,508,464,0.42857
840,0,1,0,2,803,803,0.28571
840,-49,0,0,3,804,853,0.14286
480,3,0,0,3,484,481,0.14286
0,88,0,1,4,85,-3,1
240,0,1,0,3,186,186,0.14286
840,31,0,1,4,853,822,1
240,0,1,0,3,258,258,0.14286
480,-17,0,1,4,486,503,1
840,-27,0,0,3,823,850,0.14286
840,27,0,1,4,848,821,1
240,0,1,0,3,268,268,0.14286
240,-37,0,0,3,194,231,0.14286
840,-50,0,0,2,809,859,0.28571
240,0,1,1,3,231,231,0.85714
240,0,1,1,1,225,225,0.57143
0,-6,0,1,3,12,18,0.85714
840,-2,0,1,4,857,859,1
0,13,0,0,2,7,-6,0.28571
0,-43,0,0,4,-18,25,0
480,-26,0,0,2,483,509,0.28571
480,0,1,0,3,484,484,0.14286
840,0,1,1,3,841,841,0.85714
480,-37,0,0,2,446,483,0.28571
840,0,1,1,3,838,838,0.85714
840,0,1,1,3,863,863,0.85714
840,-32,0,0,3,803,835,0.14286
480,-51,0,0,4,434,485,0
840,0,1,1,4,846,846,1
240,50,0,0,2,303,253,0.28571
240,0,1,0,3,278,278,0.14286
240,30,0,0,2,255,225,0.28571
840,0,1,1,3,832,832,0.85714
240,0,1,1,4,235,235,1
480,0,1,1,4,497,497,1
0,-2,0,0,3,2,4,0.14286
240,0,1,1,3,253,253,0.85714
480,20,0,0,3,505,485,0.14286
0,0,1,0,3,17,17,0.14286
840,30,0,1,3,872,842,0.85714
840,0,1,1,4,826,826,1
0,-14,0,0,3,-33,-19,0.14286
0,-36,0,0,4,-42,-6,0
0,0,1,1,4,3,3,1
240,24,0,1,3,277,253,0.85714
0,0,1,1,4,4,4,1
840,0,1,1,3,865,865,0.85714
240,0,1,1,2,251,251,0.71429
840,0,1,1,4,907,907,1
0,-25,0,0,3,-7,18,0.14286
840,-44,0,0,4,806,850,0
480,-9,0,1,4,454,463,1
240,0,1,0,2,216,216,0.28571
240,0,1,0,2,236,236,0.28571
240,0,1,0,3,204,204,0.14286
0,0,1,1,4,-4,-4,1
240,37,0,0,2,238,201,0.28571
840,0,1,1,3,837,837,0.85714
840,-26,0,1,4,805,831,1
0,0,1,1,4,-33,-33,1
0,26,0,0,3,40,14,0.14286
0,0,1,1,4,10,10,1
840,0,1,1,4,801,801,1
0,0,1,1,3,-7,-7,0.85714
0,0,1,1,4,-28,-28,1
840,0,1,1,3,813,813,0.85714
480,0,1,1,3,497,497,0.85714
0,0,1,1,4,-53,-53,1
840,-51,0,0,2,808,859,0.28571
840,-13,0,1,4,842,855,1
240,-25,0,0,3,198,223,0.14286
240,0,1,1,2,202,202,0.71429
840,0,1,1,3,835,835,0.85714
240,0,1,0,2,286,286,0.28571
840,20,0,1,1,835,815,0.57143
0,-26,0,0,4,-33,-7,0
0,-26,0,0,3,-1,25,0.14286
480,35,0,0,2,504,469,0.28571
840,0,1,1,3,812,812,0.85714
240,0,1,1,4,246,246,1
0,35,0,0,3,1,-34,0.14286
840,14,0,1,2,825,811,0.71429
480,-36,0,1,1,465,501,0.57143
480,0,1,1,3,537,537,0.85714
840,8,0,1,4,844,836,1
0,53,0,0,4,39,-14,0
480,-9,0,0,1,482,491,0.42857
0,0,1,1,4,21,21,1
840,-26,0,1,2,838,864,0.71429
240,0,1,1,4,271,271,1
480,0,1,1,3,508,508,0.85714
0,0,1,1,3,-13,-13,0.85714
0,0,1,1,3,-1,-1,0.85714
480,0,1,1,4,465,465,1
240,32,0,0,3,262,230,0.14286
480,0,1,1,1,450,450,0.57143
0,14,0,0,2,-6,-20,0.28571
240,15,0,0,2,266,251,0.28571
840,-34,0,1,4,827,861,1
480,0,1,1,3,494,494,0.85714
0,0,1,1,2,6,6,0.71429
0,0,1,1,4,5,5,1
0,14,0,0,1,-4,-18,0.42857
240,40,0,0,2,267,227,0.28571
480,-8,0,0,2,497,505,0.28571
840,0,1,0,1,873,873,0.42857
0,0,1,1,3,-27,-27,0.85714
480,87,0,0,3,533,446,0.14286
480,19,0,0,2,493,474,0.28571
240,-66,0,0,4,231,297,0
240,0,1,0,2,237,237,0.28571
480,0,1,1,3,483,483,0.85714
840,0,1,1,2,836,836,0.71429
840,0,1,1,4,831,831,1
0,0,1,1,3,-0,-0,0.85714
240,-12,0,1,2,238,250,0.71429
240,9,0,1,4,241,232,1
240,5,0,1,4,220,215,1
240,0,1,1,4,242,242,1
480,0,1,1,4,440,440,1
0,40,0,0,3,27,-13,0.14286
840,0,1,1,2,808,808,0.71429
240,4,0,0,2,223,219,0.28571
480,32,0,0,1,480,448,0.42857
840,-18,0,1,4,772,790,1
840,5,0,1,1,829,824,0.57143
840,0,1,1,3,852,852,0.85714
840,46,0,0,2,876,830,0.28571
240,-4,0,1,4,212,216,1
240,0,1,1,2,228,228,0.71429
240,-3,0,1,4,233,236,1
0,0,1,1,4,11,11,1
0,-15,0,0,4,-9,6,0
240,0,1,0,1,269,269,0.42857
0,0,1,1,4,47,47,1
240,-7,0,1,3,264,271,0.85714
480,0,1,1,4,463,463,1
240,31,0,0,3,256,225,0.14286
240,0,1,0,1,264,264,0.42857
480,0,1,1,3,457,457,0.85714
840,0,1,1,2,838,838,0.71429
240,0,1,1,4,281,281,1
240,0,1,1,3,171,171,0.85714
480,0,1,1,1,510,510,0.57143
240,18,0,0,3,259,241,0.14286
480,0,1,1,4,439,439,1
240,43,0,0,3,263,220,0.14286
0,-8,0,0,2,-9,-1,0.28571
840,0,1,0,1,805,805,0.42857
840,0,1,0,2,886,886,0.28571
840,0,1,0,1,885,885,0.42857
0,-33,0,0,4,4,37,0
0,-16,0,0,3,-0,16,0.14286
240,0,1,0,1,243,243,0.42857
240,0,1,1,3,249,249,0.85714
840,0,1,1,3,850,850,0.85714
840,0,1,0,1,840,840,0.42857
480,-31,0,0,2,441,472,0.28571
840,0,1,1,3,832,832,0.85714
240,-17,0,0,2,221,238,0.28571
840,-1,0,0,3,877,878,0.14286
840,0,1,0,3,889,889,0.14286
240,0,1,1,2,266,266,0.71429
840,0,1,1,1,828,828,0.57143
0,0,1,1,3,3,3,0.85714
480,-13,0,1,3,437,450,0.85714
840,-20,0,1,4,826,846,1
240,48,0,0,3,278,230,0.14286
840,0,1,1,4,832,832,1
840,0,1,1,4,831,831,1
840,67,0,0,2,867,800,0.28571
840,0,1,0,3,838,838,0.14286
840,-96,0,0,3,799,895,0.14286
840,29,0,1,3,862,833,0.85714
840,0,1,1,3,838,838,0.85714
840,0,1,0,2,811,811,0.28571
840,-3,0,1,3,864,867,0.85714
240,0,1,0,2,239,239,0.28571
480,-45,0,0,3,442,487,0.14286
0,22,0,0,3,8,-14,0.14286
840,0,1,0,1,823,823,0.42857
840,39,0,1,3,861,822,0.85714
480,0,1,1,4,432,432,1
840,0,1,1,4,838,838,1
480,0,1,1,3,478,478,0.85714
240,0,1,0,2,210,210,0.28571
480,-31,0,0,2,462,493,0.28571
840,0,1,0,3,859,859,0.14286
0,0,1,0,2,-9,-9,0.28571
480,0,1,1,4,504,504,1
0,0,1,0,2,-7,-7,0.28571
240,-30,0,0,2,240,270,0.28571
840,0,1,0,1,863,863,0.42857
240,0,1,0,1,223,223,0.42857
480,0,1,1,3,439,439,0.85714
480,0,1,1,3,456,456,0.85714
240,0,1,0,2,253,253,0.28571
0,0,1,1,4,-8,-8,1
480,0,1,1,2,498,498,0.71429
0,36,0,0,4,-2,-38,0
0,-63,0,0,4,-8,55,0
0,0,1,0,2,1,1,0.28571
0,0,1,1,3,-19,-19,0.85714
0,4,0,1,4,20,16,1
840,15,0,1,3,850,835,0.85714
480,-14,0,1,2,477,491,0.71429
480,0,1,1,3,464,464,0.85714
480,0,1,1,4,439,439,1
480,0,1,1,4,488,488,1
840,0,1,1,3,824,824,0.85714
480,0,1,1,3,517,517,0.85714
480,0,1,1,4,449,449,1
240,0,1,0,2,271,271,0.28571
240,48,0,0,3,271,223,0.14286
840,12,0,0,2,840,828,0.28571
0,0,1,1,4,-1,-1,1
240,-42,0,0,2,224,266,0.28571
240,0,1,1,3,258,258,0.85714
240,-57,0,0,3,240,297,0.14286
480,-1,0,1,4,494,495,1
480,-6,0,1,3,475,481,0.85714
840,0,1,1,3,836,836,0.85714
480,54,0,0,3,491,437,0.14286
480,-47,0,0,2,447,494,0.28571
480,-26,0,1,4,436,462,1
840,89,0,0,3,876,787,0.14286
480,-11,0,1,3,487,498,0.85714
240,0,1,1,4,209,209,1
840,0,1,1,3,849,849,0.85714
0,18,0,0,4,4,-14,0
480,30,0,0,3,490,460,0.14286
480,0,1,1,3,451,451,0.85714
0,-2,0,1,4,7,9,1
480,0,1,1,4,509,509,1
480,0,1,1,3,473,473,0.85714
840,0,1,0,3,884,884,0.14286
480,-11,0,0,3,469,480,0.14286
480,0,1,1,4,510,510,1
0,-6,0,0,3,9,15,0.14286
0,16,0,0,4,26,10,0
0,0,1,1,4,21,21,1
240,0,1,1,3,219,219,0.85714
840,0,1,1,3,838,838,0.85714
840,-7,0,1,4,847,854,1
0,0,1,1,3,20,20,0.85714
0,-32,0,0,4,-22,10,0
0,-9,0,0,3,1,10,0.14286
480,14,0,0,3,476,462,0.14286
480,-49,0,0,4,441,490,0
480,-16,0,1,4,490,506,1
0,0,1,1,3,8,8,0.85714
840,0,1,1,3,845,845,0.85714
240,7,0,1,3,242,235,0.85714
0,-2,0,0,3,-9,-7,0.14286
240,-19,0,0,4,223,242,0
480,0,1,1,4,520,520,1
480,10,0,0,2,473,463,0.28571
240,3,0,1,3,245,242,0.85714
840,0,1,1,4,850,850,1
0,41,0,0,3,33,-8,0.14286
840,-32,0,1,3,822,854,0.85714
480,0,1,1,2,492,492,0.71429
240,0,1,0,2,258,258,0.28571
0,0,1,0,3,-11,-11,0.14286
240,-4,0,1,4,234,238,1
840,0,1,1,4,773,773,1
0,22,0,0,3,11,-11,0.14286
240,2,0,0,2,255,253,0.28571
480,39,0,0,2,472,433,0.28571
480,-25,0,1,4,452,477,1
240,0,1,1,4,205,205,1
0,13,0,0,1,14,1,0.42857
240,2,0,0,2,266,264,0.28571
240,0,1,1,4,286,286,1
0,-78,0,0,4,-42,36,0
240,0,1,0,2,227,227,0.28571
240,-14,0,1,4,211,225,1
240,0,1,1,4,228,228,1
0,-28,0,0,3,0,28,0.14286
840,0,1,0,3,850,850,0.14286
840,21,0,1,3,852,831,0.85714
480,0,1,1,4,477,477,1
0,0,1,1,3,-11,-11,0.85714
240,2,0,1,3,235,233,0.85714
480,0,1,1,4,477,477,1
0,0,1,1,4,2,2,1
840,0,1,1,3,855,855,0.85714
480,-8,0,1,4,457,465,1
240,-42,0,0,3,210,252,0.14286
0,0,1,1,4,40,40,1
840,13,0,1,3,847,834,0.85714
840,0,1,1,4,860,860,1
840,53,0,1,3,851,798,0.85714
240,3,0,1,4,226,223,1
480,-36,0,1,4,474,510,1
840,0,1,1,3,848,848,0.85714
0,0,1,1,3,25,25,0.85714
240,2,0,1,2,231,229,0.71429
240,-19,0,1,3,228,247,0.85714
480,0,1,1,4,489,489,1
240,0,1,1,3,209,209,0.85714
240,-32,0,0,2,249,281,0.28571
480,0,1,1,3,503,503,0.85714
0,47,0,0,3,46,-1,0.14286
480,-66,0,0,4,446,512,0
0,32,0,0,3,24,-8,0.14286
840,0,1,1,3,878,878,0.85714
480,49,0,1,3,501,452,0.85714
240,0,1,0,2,235,235,0.28571
0,6,0,1,3,-18,-24,0.85714
240,16,0,1,3,238,222,0.85714
840,0,1,1,3,879,879,0.85714
240,-40,0,0,2,197,237,0.28571
240,0,1,1,3,242,242,0.85714
840,-25,0,1,4,812,837,1
240,10,0,0,2,241,231,0.28571
240,0,1,1,3,224,224,0.85714
0,13,0,0,2,41,28,0.28571
480,-41,0,0,3,467,508,0.14286
0,0,1,0,2,-17,-17,0.28571
480,0,1,1,3,531,531,0.85714
840,13,0,1,4,854,841,1
0,-23,0,0,2,-15,8,0.28571
0,37,0,0,3,43,6,0.14286
480,67,0,0,3,531,464,0.14286
0,45,0,0,4,17,-28,0
0,0,1,0,1,8,8,0.42857
0,33,0,0,3,34,1,0.14286
0,21,0,0,3,-7,-28,0.14286
240,12,0,0,3,253,241,0.14286
840,0,1,1,4,782,782,1
240,-4,0,1,3,228,232,0.85714
0,0,1,0,1,-14,-14,0.42857
0,0,1,1,3,-12,-12,0.85714
840,0,1,1,4,871,871,1
240,41,0,0,2,262,221,0.28571
480,-33,0,0,2,486,519,0.28571
0,59,0,0,4,38,-21,0
240,16,0,0,3,236,220,0.14286
480,-25,0,0,3,476,501,0.14286
480,0,1,1,3,488,488,0.85714
0,0,1,1,3,1,1,0.85714
480,0,1,1,4,480,480,1
0,0,1,0,3,24,24,0.14286
240,0,1,1,4,210,210,1
240,0,1,1,3,209,209,0.85714
840,0,1,1,4,842,842,1
240,45,0,0,2,285,240,0.28571
0,27,0,0,3,-7,-34,0.14286
240,0,1,0,3,235,235,0.14286
0,-2,0,0,3,-3,-1,0.14286
840,0,1,0,2,841,841,0.28571
0,0,1,1,3,-20,-20,0.85714
480,0,1,1,3,458,458,0.85714
240,0,1,1,4,195,195,1
480,0,1,1,4,470,470,1
480,0,1,1,3,462,462,0.85714
0,0,1,1,4,-17,-17,1
240,0,1,1,4,230,230,1
240,0,1,1,3,254,254,0.85714
0,0,1,1,4,8,8,1
840,-9,0,1,3,845,854,0.85714
240,67,0,0,3,266,199,0.14286
0,-34,0,0,4,-15,19,0
0,0,1,1,4,-43,-43,1
840,0,1,0,1,873,873,0.42857
0,-51,0,0,4,-21,30,0
0,0,1,0,3,16,16,0.14286
840,-59,0,0,2,788,847,0.28571
480,0,1,1,4,460,460,1
0,41,0,0,4,13,-28,0
480,-5,0,1,1,500,505,0.57143
240,-1,0,1,3,208,209,0.85714
0,0,1,1,4,45,45,1
480,0,1,1,4,440,440,1
240,32,0,0,2,254,222,0.28571
480,0,1,1,2,514,514,0.71429
0,-2,0,1,3,-18,-16,0.85714
240,38,0,0,2,243,205,0.28571
840,0,1,0,1,914,914,0.42857
240,20,0,0,1,232,212,0.42857
480,0,1,1,4,493,493,1
480,26,0,0,1,511,485,0.42857
840,0,1,1,2,872,872,0.71429
840,5,0,1,4,819,814,1
840,24,0,1,4,857,833,1
480,-27,0,0,2,463,490,0.28571
240,-23,0,0,2,257,280,0.28571
840,-7,0,1,1,846,853,0.57143
480,0,1,1,2,482,482,0.71429
480,-5,0,1,1,486,491,0.57143
240,0,1,1,2,267,267,0.71429
840,4,0,1,2,857,853,0.71429
840,116,0,0,2,896,780,0.28571
480,0,1,0,2,484,484,0.28571
480,-24,0,0,2,435,459,0.28571
240,0,1,0,1,206,206,0.42857
240,-3,0,0,1,239,242,0.42857
240,12,0,1,1,242,230,0.57143
240,10,0,0,2,261,251,0.28571
840,0,1,1,2,853,853,0.71429
0,0,1,1,3,23,23,0.85714
480,0,1,1,3,523,523,0.85714
0,0,1,1,4,-19,-19,1
480,0,1,0,2,493,493,0.28571
240,0,1,0,1,287,287,0.42857
0,33,0,0,3,17,-16,0.14286
0,-14,0,0,2,-41,-27,0.28571
840,0,1,1,3,812,812,0.85714
840,0,1,1,4,832,832,1
840,-15,0,0,3,839,854,0.14286
240,0,1,0,2,235,235,0.28571
480,9,0,1,3,438,429,0.85714
0,0,1,1,4,14,14,1
0,0,1,1,3,13,13,0.85714
840,12,0,1,4,845,833,1
240,95,0,0,3,276,181,0.14286
840,0,1,0,3,858,858,0.14286
840,0,1,0,2,873,873,0.28571
840,0,1,0,2,847,847,0.28571
480,-76,0,0,4,438,514,0
480,-17,0,0,3,491,508,0.14286
480,0,1,0,3,492,492,0.14286
840,0,1,1,4,843,843,1
480,0,1,1,3,511,511,0.85714
240,-17,0,0,3,240,257,0.14286
840,-24,0,0,2,784,808,0.28571
0,73,0,0,4,36,-37,0
0,0,1,0,3,13,13,0.14286
840,43,0,0,1,843,800,0.42857
240,0,1,0,2,223,223,0.28571
0,36,0,0,3,40,4,0.14286
240,0,1,1,3,207,207,0.85714
840,-26,0,0,2,826,852,0.28571
240,0,1,0,1,239,239,0.42857
240,0,1,0,1,255,255,0.42857
240,54,0,0,3,294,240,0.14286
840,23,0,1,4,850,827,1
240,0,1,1,3,251,251,0.85714
240,10,0,0,2,244,234,0.28571
0,-12,0,0,3,30,42,0.14286
480,-19,0,0,1,502,521,0.42857
0,0,1,0,2,6,6,0.28571
480,0,1,0,2,454,454,0.28571
240,-13,0,0,2,243,256,0.28571
0,0,1,0,3,-8,-8,0.14286
480,0,1,1,3,503,503,0.85714
840,0,1,1,3,809,809,0.85714
480,0,1,1,3,495,495,0.85714
0,30,0,0,2,-8,-38,0.28571
0,0,1,0,2,-9,-9,0.28571
480,-7,0,0,4,489,496,0
480,0,1,0,3,462,462,0.14286
840,0,1,0,3,815,815,0.14286
480,-19,0,0,2,470,489,0.28571
480,0,1,0,1,462,462,0.42857
840,-30,0,0,3,820,850,0.14286
240,0,1,0,2,207,207,0.28571
0,0,1,0,3,8,8,0.14286
840,0,1,1,3,850,850,0.85714
0,0,1,1,4,0,0,1
480,0,1,1,3,477,477,0.85714
240,34,0,0,2,270,236,0.28571
240,0,1,1,3,199,199,0.85714
480,0,1,1,3,490,490,0.85714
240,58,0,0,4,270,212,0
840,29,0,1,3,854,825,0.85714
0,14,0,0,2,-3,-17,0.28571
480,-29,0,0,1,466,495,0.42857
840,0,1,1,1,834,834,0.57143
480,-11,0,0,1,456,467,0.42857
480,0,1,1,3,531,531,0.85714
480,-42,0,0,3,461,503,0.14286
840,0,1,1,2,869,869,0.71429
0,24,0,0,3,9,-15,0.14286
840,0,1,1,3,856,856,0.85714
840,0,1,1,3,879,879,0.85714
0,-1,0,1,2,29,30,0.71429
840,0,1,1,2,867,867,0.71429
240,21,0,0,3,260,239,0.14286
840,0,1,1,3,830,830,0.85714
480,24,0,0,2,458,434,0.28571
840,0,1,1,1,853,853,0.57143
240,0,1,0,1,300,300,0.42857
0,0,1,0,3,21,21,0.14286
240,-58,0,0,2,187,245,0.28571
0,0,1,0,1,-13,-13,0.42857
480,48,0,0,2,510,462,0.28571
0,24,0,0,3,9,-15,0.14286
480,0,1,1,2,486,486,0.71429
0,0,1,0,2,5,5,0.28571
840,-13,0,1,3,849,862,0.85714
480,82,0,0,4,536,454,0
840,-71,0,0,3,819,890,0.14286
840,39,0,0,3,893,854,0.14286
240,-7,0,1,3,234,241,0.85714
840,0,1,1,4,817,817,1
840,23,0,1,2,860,837,0.71429
0,0,1,1,4,-27,-27,1
840,0,1,1,4,822,822,1
0,24,0,0,2,-1,-25,0.28571
840,0,1,1,4,802,802,1
480,0,1,1,3,525,525,0.85714
0,26,0,0,3,15,-11,0.14286
0,0,1,1,1,16,16,0.57143
240,0,1,1,1,245,245,0.57143
840,-46,0,0,2,839,885,0.28571
840,0,1,1,4,828,828,1
840,-10,0,1,4,833,843,1
840,0,1,0,2,860,860,0.28571
0,-50,0,0,4,-33,17,0
0,59,0,0,3,10,-49,0.14286
0,13,0,0,3,10,-3,0.14286
480,-49,0,0,3,463,512,0.14286
480,28,0,0,2,500,472,0.28571
480,36,0,0,2,498,462,0.28571
840,27,0,1,4,842,815,1
840,0,1,1,3,809,809,0.85714
840,39,0,0,1,845,806,0.42857
240,8,0,0,2,278,270,0.28571
840,48,0,1,3,891,843,0.85714
840,-2,0,1,4,819,821,1
240,0,1,1,3,216,216,0.85714
480,0,1,1,4,518,518,1
840,12,0,1,4,851,839,1
240,0,1,0,3,262,262,0.14286
480,67,0,0,3,525,458,0.14286
480,26,0,0,3,483,457,0.14286
240,0,1,0,2,239,239,0.28571
480,-74,0,0,4,447,521,0
0,0,1,1,2,40,40,0.71429
480,0,1,1,3,452,452,0.85714
0,0,1,1,4,-7,-7,1
240,0,1,1,2,255,255,0.71429
0,0,1,1,2,-10,-10,0.71429
480,0,1,1,1,500,500,0.57143
0,0,1,1,4,45,45,1
480,0,1,1,3,463,463,0.85714
0,0,1,1,1,25,25,0.57143
240,38,0,0,3,227,189,0.14286
240,0,1,1,1,234,234,0.57143
840,-5,0,1,3,858,863,0.85714
240,-42,0,0,3,225,267,0.14286
840,-5,0,1,3,825,830,0.85714
0,-5,0,0,1,9,14,0.42857
240,0,1,1,2,269,269,0.71429
240,0,1,1,3,227,227,0.85714
480,-33,0,1,4,459,492,1
240,0,1,1,3,266,266,0.85714
240,-24,0,1,1,258,282,0.57143
0,0,1,1,3,-25,-25,0.85714
840,-5,0,1,3,835,840,0.85714
840,31,0,1,3,843,812,0.85714
840,0,1,1,4,864,864,1
840,-29,0,1,2,814,843,0.71429
840,0,1,1,4,813,813,1
480,0,1,1,3,460,460,0.85714
0,0,1,1,4,-35,-35,1
0,0,1,1,4,39,39,1
840,-38,0,0,2,809,847,0.28571
480,2,0,1,3,471,469,0.85714
840,-12,0,1,3,842,854,0.85714
240,65,0,0,3,267,202,0.14286
840,-1,0,1,4,826,827,1
240,0,1,1,3,235,235,0.85714
0,14,0,0,2,5,-9,0.28571
840,0,1,0,3,868,868,0.14286
480,0,1,0,3,518,518,0.14286
240,0,1,0,1,229,229,0.42857
240,-16,0,0,2,226,242,0.28571
840,0,1,1,3,861,861,0.85714
840,0,1,1,3,857,857,0.85714
240,-10,0,0,3,247,257,0.14286
480,-3,0,0,3,485,488,0.14286
840,0,1,1,3,805,805,0.85714
240,0,1,1,3,257,257,0.85714
0,-8,0,0,3,-8,-0,0.14286
480,25,0,0,4,490,465,0
0,0,1,0,3,26,26,0.14286
0,16,0,1,3,-8,-24,0.85714
0,0,1,1,3,29,29,0.85714
240,39,0,1,3,285,246,0.85714
840,-16,0,1,3,792,808,0.85714
240,0,1,1,3,216,216,0.85714
0,-7,0,1,3,24,31,0.85714
480,48,0,1,3,471,423,0.85714
0,0,1,0,3,7,7,0.14286
840,0,1,0,3,857,857,0.14286
480,0,1,1,3,470,470,0.85714
480,0,1,1,4,502,502,1
240,0,1,1,3,214,214,0.85714
0,-49,0,0,3,-27,22,0.14286
240,45,0,0,4,253,208,0
240,0,1,1,3,204,204,0.85714
0,-16,0,0,3,10,26,0.14286
0,6,0,1,3,-47,-53,0.85714
240,-30,0,0,3,215,245,0.14286
840,0,1,0,2,857,857,0.28571
0,24,0,1,3,-21,-45,0.85714
480,73,0,0,2,501,428,0.28571
0,0,1,0,1,-1,-1,0.42857
480,0,1,1,3,516,516,0.85714
0,0,1,0,3,50,50,0.14286
480,4,0,1,3,494,490,0.85714
480,37,0,0,2,519,482,0.28571
0,0,1,1,3,-1,-1,0.85714
480,0,1,1,4,496,496,1
0,4,0,1,3,-1,-5,0.85714
0,-29,0,0,3,-10,19,0.14286
480,27,0,0,2,490,463,0.28571
840,-14,0,1,3,832,846,0.85714
0,-4,0,1,2,29,33,0.71429
480,0,1,1,3,482,482,0.85714
840,0,1,1,4,831,831,1
240,0,1,1,3,228,228,0.85714
0,-29,0,0,3,-19,10,0.14286
840,0,1,1,4,850,850,1
0,0,1,1,3,23,23,0.85714
240,0,1,1,3,244,244,0.85714
840,-42,0,1,2,813,855,0.71429
840,-21,0,0,3,846,867,0.14286
480,0,1,1,4,466,466,1
240,38,0,0,2,256,218,0.28571
240,0,1,1,3,220,220,0.85714
240,-9,0,1,3,205,214,0.85714
0,-24,0,0,2,-21,3,0.28571
480,0,1,1,4,432,432,1
480,-24,0,1,3,472,496,0.85714
240,0,1,1,4,259,259,1
480,0,1,1,3,472,472,0.85714
480,-4,0,1,2,462,466,0.71429
0,0,1,1,4,16,16,1
840,2,0,1,4,833,831,1
840,0,1,1,4,839,839,1
840,7,0,0,1,833,826,0.42857
480,0,1,0,1,485,485,0.42857
0,0,1,1,3,-27,-27,0.85714
840,-44,0,1,2,812,856,0.71429
240,-18,0,0,2,256,274,0.28571
0,-21,0,0,2,-59,-38,0.28571
240,0,1,1,3,269,269,0.85714
240,-24,0,1,1,245,269,0.57143
240,43,0,0,3,233,190,0.14286
480,0,1,1,3,514,514,0.85714
240,11,0,0,1,228,217,0.42857
0,0,1,1,4,-1,-1,1
480,-9,0,0,2,476,485,0.28571
0,0,1,1,4,24,24,1
480,-12,0,1,3,474,486,0.85714
840,0,1,1,3,840,840,0.85714
240,0,1,1,4,229,229,1
0,-13,0,0,2,-11,2,0.28571
0,-34,0,0,3,-9,25,0.14286
480,-18,0,0,1,492,510,0.42857
0,50,0,0,4,49,-1,0
0,0,1,0,2,-8,-8,0.28571
240,0,1,0,1,267,267,0.42857
240,0,1,0,2,256,256,0.28571
840,0,1,1,3,867,867,0.85714
480,48,0,1,3,526,478,0.85714
840,0,1,0,3,843,843,0.14286
480,-49,0,0,2,431,480,0.28571
0,61,0,0,4,37,-24,0
0,0,1,0,1,7,7,0.42857
480,-42,0,0,2,474,516,0.28571
480,-6,0,0,2,470,476,0.28571
240,40,0,0,3,255,215,0.14286
0,0,1,0,4,33,33,0
840,5,0,0,1,861,856,0.42857
480,0,1,1,3,509,509,0.85714
240,0,1,0,2,244,244,0.28571
0,0,1,0,1,-16,-16,0.42857
840,-19,0,1,3,825,844,0.85714
480,19,0,0,2,489,470,0.28571
480,11,0,1,1,484,473,0.57143
240,-11,0,1,4,230,241,1
840,0,1,1,4,833,833,1
480,0,1,1,2,485,485,0.71429
480,0,1,1,3,511,511,0.85714
480,-2,0,1,2,485,487,0.71429
480,0,1,1,4,445,445,1
0,-17,0,0,3,2,19,0.14286
840,6,0,0,1,830,824,0.42857
840,-11,0,1,3,836,847,0.85714
480,4,0,1,3,499,495,0.85714
480,0,1,1,4,494,494,1
0,10,0,0,3,1,-9,0.14286
240,0,1,0,1,243,243,0.42857
480,-30,0,0,2,439,469,0.28571
0,0,1,1,4,8,8,1
840,29,0,1,1,876,847,0.57143
840,-10,0,1,2,834,844,0.71429
240,0,1,0,2,246,246,0.28571
480,29,0,0,3,480,451,0.14286
240,38,0,0,4,283,245,0
0,-11,0,0,1,-21,-10,0.42857
840,-5,0,1,2,832,837,0.71429
240,0,1,1,1,269,269,0.57143
0,0,1,1,3,15,15,0.85714
240,27,0,0,2,267,240,0.28571
240,-30,0,0,3,188,218,0.14286
480,11,0,1,1,470,459,0.57143
240,0,1,1,1,234,234,0.57143
480,-23,0,0,2,497,520,0.28571
840,0,1,0,3,866,866,0.14286
480,0,1,0,1,468,468,0.42857
0,2,0,1,3,10,8,0.85714
840,0,1,1,2,833,833,0.71429
0,0,1,1,4,20,20,1
480,0,1,1,3,466,466,0.85714
240,15,0,0,1,230,215,0.42857
240,8,0,1,3,201,193,0.85714
240,-3,0,1,3,253,256,0.85714
0,0,1,1,4,-18,-18,1
240,0,1,0,2,246,246,0.28571
840,0,1,0,2,858,858,0.28571
0,0,1,1,3,-39,-39,0.85714
480,-57,0,0,2,433,490,0.28571
240,-7,0,1,3,259,266,0.85714
840,0,1,1,4,829,829,1
240,22,0,1,2,242,220,0.71429
480,11,0,1,2,454,443,0.71429
480,-50,0,0,2,472,522,0.28571
480,0,1,1,4,466,466,1
0,30,0,0,3,9,-21,0.14286
840,-6,0,0,2,857,863,0.28571
0,0,1,1,3,-4,-4,0.85714
240,10,0,0,1,239,229,0.42857
840,0,1,1,2,819,819,0.71429
840,43,0,0,2,865,822,0.28571
840,0,1,1,1,859,859,0.57143
480,38,0,0,2,499,461,0.28571
840,0,1,0,3,828,828,0.14286
240,0,1,0,2,244,244,0.28571
840,0,1,0,1,883,883,0.42857
840,0,1,0,1,827,827,0.42857
480,8,0,1,1,501,493,0.57143
240,0,1,0,2,269,269,0.28571
840,17,0,0,1,864,847,0.42857
0,0,1,1,4,13,13,1
840,0,1,0,3,845,845,0.14286
480,-4,0,0,2,493,497,0.28571
480,0,1,1,2,493,493,0.71429
0,-4,0,0,2,-10,-6,0.28571
240,0,1,0,1,247,247,0.42857
0,-14,0,0,2,-3,11,0.28571
240,-9,0,0,1,218,227,0.42857
840,0,1,1,2,867,867,0.71429
840,0,1,1,3,843,843,0.85714
840,0,1,1,4,833,833,1
240,47,0,0,3,245,198,0.14286
480,0,1,0,1,455,455,0.42857
0,-25,0,0,3,13,38,0.14286
0,0,1,1,4,-20,-20,1
480,-21,0,0,1,473,494,0.42857
480,0,1,1,3,495,495,0.85714
480,59,0,0,2,546,487,0.28571
240,0,1,1,3,225,225,0.85714
480,-37,0,0,2,452,489,0.28571
480,0,1,1,1,470,470,0.57143
0,-32,0,0,3,-38,-6,0.14286
480,0,1,1,4,492,492,1
240,-20,0,1,1,277,297,0.57143
240,0,1,1,3,268,268,0.85714
0,0,1,1,2,16,16,0.71429
240,-55,0,0,3,231,286,0.14286
840,0,1,1,4,835,835,1
840,-35,0,0,1,812,847,0.42857
840,0,1,1,3,847,847,0.85714
240,0,1,1,4,226,226,1
240,-25,0,0,2,212,237,0.28571
840,3,0,1,4,808,805,1
240,0,1,0,2,217,217,0.28571
840,0,1,1,3,834,834,0.85714
240,14,0,0,1,224,210,0.42857
240,9,0,0,2,253,244,0.28571
0,14,0,0,3,3,-11,0.14286
480,0,1,0,2,461,461,0.28571
240,0,1,0,1,266,266,0.42857
840,0,1,1,3,811,811,0.85714
480,0,1,1,2,496,496,0.71429
0,21,0,0,2,-2,-23,0.28571
840,0,1,0,1,805,805,0.42857
480,0,1,0,2,461,461,0.28571
0,0,1,0,3,14,14,0.14286
0,39,0,0,3,0,-39,0.14286
480,0,1,1,4,514,514,1
0,30,0,0,2,-14,-44,0.28571
0,50,0,0,4,10,-40,0
0,0,1,1,3,34,34,0.85714
240,0,1,0,2,228,228,0.28571
840,50,0,0,3,866,816,0.14286
840,16,0,0,1,861,845,0.42857
240,87,0,0,4,287,200,0
0,0,1,0,2,-19,-19,0.28571
0,30,0,0,4,46,16,0
480,5,0,1,4,487,482,1
840,0,1,1,3,843,843,0.85714
0,27,0,0,2,-9,-36,0.28571
0,17,0,0,1,-4,-21,0.42857
240,0,1,1,2,249,249,0.71429
480,0,1,0,2,532,532,0.28571
0,0,1,1,4,16,16,1
0,0,1,1,3,8,8,0.85714
480,12,0,0,2,470,458,0.28571
480,0,1,0,1,491,491,0.42857
480,0,1,1,3,470,470,0.85714
480,-10,0,1,3,446,456,0.85714
840,-8,0,1,2,828,836,0.71429
0,-14,0,0,1,25,39,0.42857
0,16,0,0,3,-5,-21,0.14286
840,22,0,1,3,873,851,0.85714
480,33,0,0,3,481,448,0.14286
240,-12,0,0,3,250,262,0.14286
240,0,1,0,3,243,243,0.14286
0,0,1,1,4,0,0,1
480,0,1,1,3,476,476,0.85714
240,0,1,1,4,214,214,1
0,0,1,1,3,5,5,0.85714
840,0,1,1,2,818,818,0.71429
0,-67,0,0,4,-21,46,0
480,-18,0,0,2,456,474,0.28571
240,0,1,0,1,241,241,0.42857
240,0,1,1,2,241,241,0.71429
480,71,0,1,3,473,402,0.85714
840,0,1,1,4,828,828,1
480,-22,0,1,3,477,499,0.85714
0,-33,0,0,4,-23,10,0
480,0,1,0,3,490,490,0.14286
0,-8,0,0,1,1,9,0.42857
480,16,0,0,2,509,493,0.28571
840,-7,0,0,3,806,813,0.14286
480,20,0,1,2,485,465,0.71429
840,4,0,1,3,926,922,0.85714
480,0,1,0,3,471,471,0.14286
240,0,1,1,3,260,260,0.85714
480,-39,0,1,4,427,466,1
0,0,1,0,2,12,12,0.28571
840,-25,0,1,4,826,851,1
840,0,1,1,3,798,798,0.85714
240,0,1,0,3,260,260,0.14286
240,0,1,1,4,283,283,1
0,18,0,0,2,-19,-37,0.28571
480,0,1,0,1,484,484,0.42857
0,0,1,1,3,10,10,0.85714
840,0,1,1,4,828,828,1
840,0,1,1,2,851,851,0.71429
240,0,1,1,3,311,311,0.85714
240,-50,0,0,2,217,267,0.28571
0,0,1,1,3,-11,-11,0.85714
480,-20,0,0,3,455,475,0.14286
480,17,0,0,3,490,473,0.14286
0,22,0,1,3,15,-7,0.85714
480,0,1,1,4,493,493,1
840,0,1,1,1,837,837,0.57143
840,0,1,1,3,821,821,0.85714
840,0,1,1,4,832,832,1
0,-7,0,1,3,0,7,0.85714
840,0,1,1,4,806,806,1
240,-45,0,0,2,226,271,0.28571
840,0,1,1,4,807,807,1
840,-38,0,0,2,831,869,0.28571
480,-47,0,0,3,465,512,0.14286
0,0,1,1,3,0,0,0.85714
0,0,1,1,4,4,4,1
240,0,1,1,2,230,230,0.71429
240,-68,0,0,2,178,246,0.28571
840,22,0,0,1,855,833,0.42857
0,0,1,0,2,-7,-7,0.28571
480,0,1,1,4,482,482,1
840,0,1,1,4,805,805,1
480,35,0,1,3,513,478,0.85714
480,0,1,1,2,466,466,0.71429
0,0,1,1,3,33,33,0.85714
840,16,0,1,4,834,818,1
0,36,0,0,3,13,-23,0.14286
840,0,1,0,2,822,822,0.28571
0,0,1,1,4,-4,-4,1
840,0,1,1,3,846,846,0.85714
0,0,1,1,3,21,21,0.85714
0,-31,0,0,3,15,46,0.14286
840,-51,0,0,3,816,867,0.14286
480,0,1,1,3,515,515,0.85714
480,26,0,1,2,486,460,0.71429
240,-18,0,0,2,223,241,0.28571
480,0,1,1,4,492,492,1
0,1,0,1,3,29,28,0.85714
840,0,1,1,2,835,835,0.71429
240,19,0,1,4,261,242,1
480,0,1,1,3,475,475,0.85714
840,30,0,1,2,865,835,0.71429
840,-23,0,1,4,839,862,1
0,-10,0,0,2,-19,-9,0.28571
0,-89,0,0,4,-49,40,0
0,-7,0,0,3,-20,-13,0.14286
840,-51,0,0,3,782,833,0.14286
840,0,1,1,3,850,850,0.85714
480,0,1,1,2,482,482,0.71429
240,32,0,1,4,261,229,1
480,0,1,1,3,452,452,0.85714
0,0,1,1,4,-11,-11,1
240,10,0,0,2,233,223,0.28571
480,0,1,1,4,514,514,1
480,0,1,1,2,468,468,0.71429
0,-34,0,0,4,4,38,0
840,3,0,1,2,865,862,0.71429
0,0,1,1,4,-31,-31,1
840,28,0,0,1,845,817,0.42857
0,0,1,1,4,-35,-35,1
240,0,1,1,3,229,229,0.85714
240,-17,0,0,2,246,263,0.28571
840,0,1,1,4,859,859,1
240,0,1,1,3,224,224,0.85714
480,0,1,1,4,494,494,1
840,1,0,0,2,823,822,0.28571
0,41,0,0,4,13,-28,0
240,-68,0,0,4,223,291,0
0,0,1,0,2,-27,-27,0.28571
0,0,1,1,3,22,22,0.85714
840,19,0,1,2,884,865,0.71429
840,19,0,1,3,891,872,0.85714
0,0,1,0,2,9,9,0.28571
240,-31,0,0,3,217,248,0.14286
480,64,0,0,3,500,436,0.14286
480,0,1,1,4,477,477,1
240,26,0,1,3,260,234,0.85714
240,-27,0,0,3,235,262,0.14286
840,-27,0,0,3,838,865,0.14286
480,22,0,1,2,452,430,0.71429
0,-24,0,0,4,-46,-22,0
0,0,1,0,3,-30,-30,0.14286
480,37,0,0,2,497,460,0.28571
840,0,1,1,4,844,844,1
240,-7,0,1,3,214,221,0.85714
480,-13,0,1,4,473,486,1
240,42,0,0,3,274,232,0.14286
840,0,1,1,3,852,852,0.85714
240,0,1,1,4,242,242,1
480,11,0,1,2,546,535,0.71429
480,0,1,1,3,516,516,0.85714
0,-2,0,1,4,-12,-10,1
0,0,1,1,3,8,8,0.85714
840,0,1,1,4,872,872,1
0,24,0,0,2,42,18,0.28571
0,0,1,0,4,-8,-8,0
840,0,1,0,3,856,856,0.14286
480,-63,0,0,4,457,520,0
480,0,1,0,2,455,455,0.28571
240,-4,0,0,3,241,245,0.14286
240,64,0,0,4,251,187,0
240,-66,0,0,3,205,271,0.14286
240,0,1,1,1,248,248,0.57143
480,0,1,1,3,467,467,0.85714
480,0,1,1,4,490,490,1
240,0,1,0,2,270,270,0.28571
840,26,0,0,1,852,826,0.42857
240,0,1,0,3,221,221,0.14286
840,0,1,1,4,811,811,1
480,22,0,0,2,490,468,0.28571
240,10,0,0,4,252,242,0
840,-5,0,1,3,888,893,0.85714
480,12,0,1,4,465,453,1
0,13,0,0,3,19,6,0.14286
840,33,0,1,4,839,806,1
480,0,1,1,4,504,504,1
840,-1,0,1,3,839,840,0.85714
480,-19,0,0,3,438,457,0.14286
0,-42,0,0,4,-30,12,0
240,0,1,0,1,223,223,0.42857
840,-12,0,0,3,844,856,0.14286
240,16,0,0,1,244,228,0.42857
240,0,1,1,4,259,259,1
240,0,1,0,3,251,251,0.14286
240,0,1,0,2,231,231,0.28571
840,0,1,1,4,814,814,1
840,16,0,1,3,801,785,0.85714
480,-2,0,0,3,473,475,0.14286
480,-7,0,0,2,454,461,0.28571
240,0,1,0,4,217,217,0
840,0,1,1,4,838,838,1
240,-8,0,1,3,247,255,0.85714
480,0,1,1,3,511,511,0.85714
0,0,1,1,2,7,7,0.71429
0,0,1,1,3,-10,-10,0.85714
480,0,1,1,4,521,521,1
240,53,0,0,4,274,221,0
840,0,1,1,4,836,836,1
480,0,1,1,3,479,479,0.85714
240,0,1,0,2,263,263,0.28571
0,10,0,0,3,19,9,0.14286
480,0,1,0,2,499,499,0.28571
480,-41,0,0,4,452,493,0
0,0,1,0,2,30,30,0.28571
240,0,1,0,2,230,230,0.28571
0,0,1,1,4,-36,-36,1
480,-84,0,0,3,433,517,0.14286
840,0,1,0,3,819,819,0.14286
480,45,0,0,3,481,436,0.14286
480,-37,0,0,2,437,474,0.28571
480,0,1,1,3,499,499,0.85714
840,0,1,1,4,831,831,1
840,0,1,1,2,814,814,0.71429
240,-53,0,0,3,216,269,0.14286
480,0,1,0,4,482,482,0
480,0,1,1,3,472,472,0.85714
480,6,0,1,4,498,492,1
840,28,0,0,2,853,825,0.28571
480,-27,0,0,3,466,493,0.14286
0,0,1,1,3,14,14,0.85714
240,-20,0,1,2,247,267,0.71429
240,-7,0,0,3,233,240,0.14286
480,1,0,1,3,490,489,0.85714
240,0,1,1,2,253,253,0.71429
0,14,0,0,2,28,14,0.28571
240,0,1,1,3,239,239,0.85714
0,0,1,1,4,63,63,1
240,0,1,1,2,306,306,0.71429
240,0,1,1,3,232,232,0.85714
480,0,1,0,3,488,488,0.14286
840,0,1,1,4,849,849,1
0,0,1,1,3,3,3,0.85714
240,0,1,0,2,222,222,0.28571
480,0,1,0,3,466,466,0.14286
480,56,0,0,3,512,456,0.14286
840,-18,0,1,4,808,826,1
240,0,1,1,2,208,208,0.71429
480,0,1,1,3,480,480,0.85714
480,0,1,1,3,481,481,0.85714
0,0,1,1,2,-31,-31,0.71429
0,0,1,1,3,39,39,0.85714
0,-10,0,0,2,29,39,0.28571
0,0,1,1,4,-34,-34,1
240,0,1,1,3,255,255,0.85714
240,-6,0,1,4,223,229,1
480,0,1,1,2,484,484,0.71429
480,0,1,1,3,516,516,0.85714
0,22,0,0,2,4,-18,0.28571
840,55,0,0,1,887,832,0.42857
240,9,0,0,3,235,226,0.14286
0,-37,0,0,4,-21,16,0
240,0,1,0,2,231,231,0.28571
480,-11,0,1,3,450,461,0.85714
480,0,1,1,2,458,458,0.71429
240,0,1,0,2,242,242,0.28571
240,0,1,1,3,202,202,0.85714
240,0,1,1,4,246,246,1
240,-4,0,0,2,261,265,0.28571
0,0,1,1,3,12,12,0.85714
480,0,1,1,3,480,480,0.85714
840,0,1,1,4,874,874,1
0,0,1,0,3,3,3,0.14286
0,-26,0,0,2,-18,8,0.28571
480,-44,0,0,2,452,496,0.28571
840,20,0,0,3,882,862,0.14286
840,0,1,0,3,835,835,0.14286
840,0,1,1,3,843,843,0.85714
840,-11,0,1,3,832,843,0.85714
480,36,0,1,3,525,489,0.85714
480,-67,0,1,2,447,514,0.71429
240,0,1,1,3,267,267,0.85714
240,0,1,1,2,260,260,0.71429
840,0,1,1,4,840,840,1
0,0,1,1,3,-17,-17,0.85714
0,0,1,1,4,-6,-6,1
840,0,1,1,3,851,851,0.85714
240,22,0,0,2,250,228,0.28571
840,17,0,1,3,865,848,0.85714
240,-5,0,1,4,228,233,1
0,16,0,0,2,-23,-39,0.28571
840,0,1,1,4,882,882,1
480,48,0,0,2,497,449,0.28571
0,0,1,0,2,16,16,0.28571
840,0,1,1,4,854,854,1
0,0,1,1,3,-19,-19,0.85714
480,0,1,1,2,441,441,0.71429
240,0,1,1,4,184,184,1
0,0,1,0,2,57,57,0.28571
840,0,1,1,3,803,803,0.85714
0,3,0,1,3,-4,-7,0.85714
240,-17,0,1,4,191,208,1
0,-25,0,0,2,-21,4,0.28571
0,36,0,0,3,17,-19,0.14286
0,-15,0,0,4,-24,-9,0
0,-11,0,1,3,-30,-19,0.85714
240,9,0,1,4,222,213,1
240,0,1,1,2,290,290,0.71429
480,14,0,1,3,529,515,0.85714
0,-37,0,0,4,-14,23,0
240,23,0,0,2,242,219,0.28571
0,22,0,0,3,-9,-31,0.14286
240,0,1,0,2,232,232,0.28571
480,2,0,0,1,470,468,0.42857
840,0,1,1,3,832,832,0.85714
0,0,1,0,2,-16,-16,0.28571
240,0,1,0,1,236,236,0.42857
480,69,0,0,3,537,468,0.14286
240,0,1,0,2,231,231,0.28571
480,0,1,0,1,502,502,0.42857
840,35,0,0,2,834,799,0.28571
840,12,0,0,3,873,861,0.14286
240,4,0,0,4,238,234,0
0,14,0,0,2,48,34,0.28571
840,18,0,0,1,851,833,0.42857
240,0,1,0,3,214,214,0.14286
0,0,1,1,3,55,55,0.85714
240,56,0,0,4,244,188,0
240,0,1,0,2,278,278,0.28571
0,17,0,0,3,15,-2,0.14286
240,-30,0,0,1,239,269,0.42857
480,0,1,1,3,479,479,0.85714
840,51,0,0,1,884,833,0.42857
240,-9,0,1,3,224,233,0.85714
0,-3,0,1,4,-14,-11,1
480,1,0,1,3,475,474,0.85714
0,0,1,1,4,-23,-23,1
240,0,1,1,3,225,225,0.85714
840,21,0,1,2,863,842,0.71429
840,-21,0,1,4,845,866,1
480,0,1,1,2,456,456,0.71429
0,68,0,0,4,20,-48,0
240,-14,0,1,4,223,237,1
240,0,1,1,3,251,251,0.85714
840,0,1,1,4,817,817,1
480,-1,0,1,3,511,512,0.85714
840,-10,0,1,4,840,850,1
240,13,0,0,2,219,206,0.28571
0,0,1,1,3,12,12,0.85714
840,0,1,1,4,841,841,1
0,0,1,1,3,-44,-44,0.85714
240,52,0,0,3,259,207,0.14286
0,0,1,1,4,-13,-13,1
840,-5,0,1,3,830,835,0.85714
0,51,0,0,3,28,-23,0.14286
0,0,1,1,4,-26,-26,1
840,18,0,1,3,862,844,0.85714
480,9,0,1,4,484,475,1
0,47,0,1,3,48,1,0.85714
480,9,0,1,2,478,469,0.71429
240,-15,0,1,4,218,233,1
480,0,1,1,3,458,458,0.85714
0,15,0,0,2,13,-2,0.28571
840,39,0,1,3,840,801,0.85714
0,17,0,1,1,-29,-46,0.57143
0,-14,0,0,2,1,15,0.28571
0,0,1,1,4,64,64,1
0,0,1,1,4,-14,-14,1
240,0,1,0,2,259,259,0.28571
480,0,1,1,4,490,490,1
840,0,1,1,3,869,869,0.85714
0,-10,0,1,2,1,11,0.71429
840,-2,0,1,3,853,855,0.85714
840,-57,0,0,3,815,872,0.14286
0,2,0,1,4,12,10,1
0,-22,0,0,2,-16,6,0.28571
240,-12,0,1,1,238,250,0.57143
240,-5,0,0,3,226,231,0.14286
480,0,1,1,3,457,457,0.85714
480,3,0,1,4,468,465,1
240,0,1,1,2,252,252,0.71429
480,0,1,1,4,451,451,1
480,-32,0,0,3,479,511,0.14286
240,14,0,1,3,239,225,0.85714
480,0,1,1,4,485,485,1
240,0,1,1,4,226,226,1
840,7,0,1,2,818,811,0.71429
240,35,0,0,2,291,256,0.28571
0,0,1,1,4,38,38,1
480,0,1,0,4,511,511,0
0,0,1,1,3,20,20,0.85714
480,0,1,1,2,490,490,0.71429
240,0,1,1,4,260,260,1
0,-16,0,0,2,-20,-4,0.28571
480,0,1,1,3,473,473,0.85714
480,-51,0,0,4,487,538,0
240,0,1,1,3,257,257,0.85714
480,-22,0,0,3,489,511,0.14286
480,0,1,1,4,470,470,1
840,-56,0,0,3,780,836,0.14286
0,0,1,1,4,44,44,1
840,93,0,0,4,901,808,0
0,0,1,1,3,20,20,0.85714
840,-24,0,0,3,832,856,0.14286
840,0,1,1,3,860,860,0.85714
480,-6,0,1,4,468,474,1
240,0,1,1,3,218,218,0.85714
840,0,1,0,3,766,766,0.14286
240,-16,0,0,2,234,250,0.28571
240,12,0,1,3,262,250,0.85714
480,-11,0,1,4,460,471,1
0,19,0,0,2,11,-8,0.28571
840,0,1,1,4,832,832,1
840,-59,0,0,2,827,886,0.28571
240,0,1,1,3,233,233,0.85714
480,36,0,0,2,502,466,0.28571
840,0,1,1,4,818,818,1
0,-28,0,0,4,-18,10,0
840,-30,0,1,3,855,885,0.85714
240,0,1,0,2,248,248,0.28571
480,-2,0,0,1,477,479,0.42857
840,38,0,1,4,858,820,1
480,44,0,0,4,508,464,0
840,0,1,0,3,803,803,0.14286
840,-49,0,0,2,804,853,0.28571
480,3,0,1,4,484,481,1
0,88,0,0,4,85,-3,0
240,0,1,0,2,186,186,0.28571
840,31,0,0,1,853,822,0.42857
240,0,1,0,2,258,258,0.28571
480,-17,0,0,3,486,503,0.14286
840,-27,0,0,2,823,850,0.28571
840,27,0,1,4,848,821,1
240,0,1,1,2,268,268,0.71429
240,-37,0,0,3,194,231,0.14286
840,-50,0,0,4,809,859,0
240,0,1,1,4,231,231,1
240,0,1,0,1,225,225,0.42857
0,-6,0,0,2,12,18,0.28571
840,-2,0,1,3,857,859,0.85714
0,13,0,0,2,7,-6,0.28571
0,-43,0,0,3,-18,25,0.14286
480,-26,0,1,4,483,509,1
480,0,1,1,2,484,484,0.71429
840,0,1,1,4,841,841,1
480,-37,0,1,3,446,483,0.85714
840,0,1,1,3,838,838,0.85714
840,0,1,1,3,863,863,0.85714
840,-32,0,0,2,803,835,0.28571
480,-51,0,0,3,434,485,0.14286
840,0,1,0,2,846,846,0.28571
240,0,1,0,2,278,278,0.28571
240,30,0,0,3,255,225,0.14286
840,0,1,1,4,832,832,1
240,0,1,1,3,235,235,0.85714
480,0,1,1,4,497,497,1
0,-2,0,1,3,2,4,0.85714
240,0,1,1,4,253,253,1
480,20,0,1,2,505,485,0.71429
0,0,1,1,4,17,17,1
840,30,0,1,3,872,842,0.85714
840,0,1,1,4,826,826,1
0,-14,0,1,2,-33,-19,0.71429
0,-36,0,0,3,-42,-6,0.14286
0,0,1,1,4,3,3,1
240,24,0,0,3,277,253,0.14286
0,0,1,1,3,4,4,0.85714
840,0,1,1,4,865,865,1
240,0,1,1,3,251,251,0.85714
840,0,1,1,4,907,907,1
0,-25,0,0,2,-7,18,0.28571
840,-44,0,1,4,806,850,1
480,-9,0,1,3,454,463,0.85714
240,0,1,1,3,216,216,0.85714
240,0,1,1,3,236,236,0.85714
240,0,1,1,4,204,204,1
0,0,1,1,3,-4,-4,0.85714
240,37,0,0,3,238,201,0.14286
840,0,1,1,4,837,837,1
840,-26,0,1,3,805,831,0.85714
0,0,1,1,2,-33,-33,0.71429
0,26,0,0,4,40,14,0
0,0,1,1,4,10,10,1
840,0,1,1,4,801,801,1
0,0,1,1,4,-7,-7,1
0,0,1,1,3,-28,-28,0.85714
840,0,1,1,4,813,813,1
480,0,1,1,3,497,497,0.85714
0,0,1,1,4,-53,-53,1
840,-51,0,0,2,808,859,0.28571
840,-13,0,1,4,842,855,1
