840,0,1,1,4,853,853,1
480,0,1,1,3,508,508,0.85714
240,-52,0,0,4,231,283,0
0,83,0,0,4,46,-37,0
240,22,0,1,3,252,230,0.85714
840,0,1,1,4,820,820,1
240,0,1,0,4,236,236,0
240,0,1,0,4,194,194,0
0,-51,0,0,4,4,55,0
0,0,1,0,4,-44,-44,0
480,-40,0,1,4,461,501,1
480,12,0,1,3,499,487,0.85714
840,-21,0,1,4,828,849,1
840,48,0,1,4,869,821,1
480,0,1,1,4,474,474,1
0,40,0,0,4,20,-20,0
240,0,1,1,3,240,240,0.85714
0,-28,0,0,4,-28,0,0
480,-18,0,1,2,485,503,0.71429
840,0,1,0,4,833,833,0
840,39,0,0,3,871,832,0.14286
240,-32,0,0,2,198,230,0.28571
480,0,1,1,4,455,455,1
0,51,0,0,3,45,-6,0.14286
480,16,0,1,4,496,480,1
840,-28,0,1,2,817,845,0.71429
0,-37,0,0,3,-27,10,0.14286
840,0,1,1,4,840,840,1
840,0,1,1,4,850,850,1
0,67,0,0,4,33,-34,0
840,-93,0,0,3,833,926,0.14286
0,0,1,1,4,-7,-7,1
480,-10,0,1,4,452,462,1
0,0,1,1,4,-24,-24,1
0,0,1,1,4,-37,-37,1
0,0,1,1,4,37,37,1
480,0,1,1,4,476,476,1
240,0,1,1,3,250,250,0.85714
840,37,0,0,4,860,823,0
0,15,0,1,4,10,-5,1
0,39,0,1,4,13,-26,1
240,-22,0,1,3,218,240,0.85714
840,0,1,1,2,796,796,0.71429
840,0,1,0,4,820,820,0
0,0,1,1,4,-5,-5,1
480,0,1,1,4,468,468,1
0,-16,0,0,3,15,31,0.14286
840,24,0,0,2,856,832,0.28571
840,-11,0,0,2,850,861,0.28571
240,0,1,1,4,244,244,1
840,7,0,1,3,854,847,0.85714
240,-90,0,0,4,185,275,0
0,0,1,1,4,-10,-10,1
480,11,0,1,4,477,466,1
480,0,1,1,4,502,502,1
240,27,0,1,4,243,216,1
0,0,1,1,4,49,49,1
0,49,0,1,4,3,-46,1
0,0,1,1,4,2,2,1
480,0,1,1,4,514,514,1
240,0,1,1,4,231,231,1
240,0,1,1,4,188,188,1
0,15,0,1,4,-23,-38,1
480,13,0,0,2,505,492,0.28571
240,0,1,0,2,255,255,0.28571
240,31,0,0,3,245,214,0.14286
480,0,1,1,2,477,477,0.71429
240,0,1,1,2,249,249,0.71429
0,0,1,1,4,-5,-5,1
240,0,1,1,4,264,264,1
0,-36,0,0,3,-19,17,0.14286
840,0,1,1,4,898,898,1
240,0,1,1,4,244,244,1
480,-6,0,1,4,467,473,1
0,-8,0,1,4,-13,-5,1
840,-55,0,0,2,801,856,0.28571
240,0,1,1,4,234,234,1
240,39,0,0,2,230,191,0.28571
480,0,1,0,3,434,434,0.14286
240,4,0,1,3,221,217,0.85714
0,0,1,1,4,-39,-39,1
0,-32,0,0,2,-14,18,0.28571
480,0,1,0,3,505,505,0.14286
480,-24,0,1,4,454,478,1
840,-32,0,1,4,826,858,1
840,14,0,1,4,869,855,1
840,0,1,1,3,829,829,0.85714
0,-22,0,1,4,-9,13,1
0,0,1,1,4,22,22,1
480,0,1,1,4,468,468,1
240,-16,0,1,4,222,238,1
840,0,1,1,4,880,880,1
240,0,1,1,4,229,229,1
480,-7,0,1,4,457,464,1
480,-17,0,1,4,478,495,1
240,0,1,1,4,220,220,1
480,0,1,1,4,471,471,1
240,0,1,1,4,222,222,1
480,47,0,1,4,514,467,1
480,0,1,0,2,494,494,0.28571
240,0,1,1,4,232,232,1
0,57,0,1,4,27,-30,1
840,39,0,0,1,898,859,0.42857
480,46,0,1,4,523,477,1
240,0,1,1,3,262,262,0.85714
240,0,1,1,3,293,293,0.85714
240,0,1,1,3,225,225,0.85714
240,0,1,1,4,267,267,1
0,47,0,1,4,20,-27,1
840,0,1,0,1,848,848,0.42857
240,0,1,1,4,223,223,1
0,0,1,1,4,0,0,1
240,15,0,1,3,233,218,0.85714
0,0,1,1,4,32,32,1
480,23,0,1,2,496,473,0.71429
840,31,0,1,4,848,817,1
480,0,1,1,3,464,464,0.85714
480,35,0,1,2,514,479,0.71429
0,20,0,1,4,17,-3,1
240,33,0,1,4,254,221,1
0,28,0,1,4,6,-22,1
240,0,1,1,3,231,231,0.85714
480,31,0,1,2,519,488,0.71429
480,50,0,0,3,497,447,0.14286
0,7,0,1,4,11,4,1
0,40,0,0,1,63,23,0.42857
240,0,1,1,2,266,266,0.71429
0,0,1,1,4,14,14,1
480,0,1,1,3,495,495,0.85714
0,0,1,1,4,19,19,1
480,41,0,0,1,496,455,0.42857
840,0,1,0,2,852,852,0.28571
840,-32,0,1,4,844,876,1
840,-14,0,1,4,845,859,1
480,33,0,1,4,532,499,1
0,23,0,1,4,22,-1,1
240,-15,0,1,4,244,259,1
240,0,1,1,4,235,235,1
840,0,1,1,4,851,851,1
840,0,1,1,4,817,817,1
0,0,1,1,4,1,1,1
240,0,1,1,4,220,220,1
0,0,1,1,4,13,13,1
0,0,1,1,4,29,29,1
240,0,1,1,4,234,234,1
240,-35,0,1,4,253,288,1
840,0,1,0,1,819,819,0.42857
0,0,1,1,2,37,37,0.71429
840,63,0,1,4,849,786,1
840,0,1,1,4,874,874,1
240,6,0,1,4,266,260,1
840,-11,0,1,3,836,847,0.85714
0,0,1,1,4,29,29,1
480,-57,0,1,2,446,503,0.71429
840,-21,0,1,3,821,842,0.85714
240,11,0,1,4,244,233,1
240,-8,0,1,4,242,250,1
0,18,0,1,4,11,-7,1
0,36,0,0,3,17,-19,0.14286
480,0,1,0,2,480,480,0.28571
0,0,1,1,4,7,7,1
840,0,1,1,4,825,825,1
0,-34,0,1,4,-18,16,1
480,-15,0,1,3,471,486,0.85714
240,0,1,1,4,237,237,1
840,-22,0,1,2,819,841,0.71429
840,0,1,1,2,823,823,0.71429
0,0,1,1,4,10,10,1
840,0,1,1,4,862,862,1
0,10,0,1,4,20,10,1
240,0,1,1,4,206,206,1
840,0,1,1,2,788,788,0.71429
0,0,1,0,2,27,27,0.28571
240,0,1,1,4,271,271,1
480,0,1,1,4,513,513,1
840,-10,0,1,2,837,847,0.71429
840,0,1,1,3,846,846,0.85714
480,0,1,1,4,492,492,1
480,-8,0,1,4,492,500,1
240,38,0,1,4,243,205,1
240,10,0,1,4,244,234,1
240,0,1,1,4,276,276,1
480,0,1,1,2,481,481,0.71429
0,-11,0,1,4,7,18,1
840,0,1,1,4,826,826,1
240,0,1,1,4,273,273,1
480,-12,0,1,4,469,481,1
840,0,1,1,4,835,835,1
480,-14,0,0,2,444,458,0.28571
480,-1,0,0,3,465,466,0.14286
480,-2,0,1,4,474,476,1
240,0,1,1,3,205,205,0.85714
480,0,1,1,2,489,489,0.71429
840,0,1,1,4,839,839,1
0,-79,0,0,4,-16,63,0
0,50,0,0,4,43,-7,0
240,0,1,1,3,245,245,0.85714
480,0,1,1,3,456,456,0.85714
480,0,1,0,2,473,473,0.28571
240,11,0,1,4,246,235,1
480,0,1,1,4,493,493,1
0,0,1,0,4,-52,-52,0
240,0,1,1,3,194,194,0.85714
480,49,0,0,2,531,482,0.28571
0,34,0,1,4,-19,-53,1
480,0,1,1,4,499,499,1
240,0,1,1,4,241,241,1
240,-26,0,0,3,232,258,0.14286
240,-34,0,0,2,226,260,0.28571
0,0,1,1,4,-21,-21,1
840,18,0,0,2,876,858,0.28571
480,-25,0,0,2,495,520,0.28571
240,4,0,0,1,236,232,0.42857
240,0,1,1,4,252,252,1
840,41,0,0,1,878,837,0.42857
480,0,1,1,2,486,486,0.71429
240,-35,0,0,4,226,261,0
0,-34,0,0,4,-24,10,0
0,-17,0,0,4,-25,-8,0
0,-23,0,0,4,4,27,0
240,-6,0,1,2,230,236,0.71429
840,0,1,0,2,828,828,0.28571
840,0,1,1,4,841,841,1
480,0,1,0,2,493,493,0.28571
480,0,1,1,3,514,514,0.85714
0,50,0,0,4,31,-19,0
240,0,1,1,3,231,231,0.85714
240,0,1,1,2,251,251,0.71429
480,-35,0,0,1,441,476,0.42857
0,92,0,0,1,64,-28,0.42857
840,0,1,1,2,818,818,0.71429
840,34,0,1,1,863,829,0.57143
0,0,1,1,4,-22,-22,1
240,0,1,1,2,238,238,0.71429
840,-11,0,0,3,828,839,0.14286
0,0,1,1,3,-28,-28,0.85714
480,0,1,1,2,494,494,0.71429
240,0,1,1,3,240,240,0.85714
240,27,0,1,3,269,242,0.85714
240,22,0,1,4,209,187,1
480,-4,0,0,3,482,486,0.14286
840,0,1,0,2,814,814,0.28571
240,26,0,0,2,247,221,0.28571
240,19,0,1,3,249,230,0.85714
480,0,1,1,2,437,437,0.71429
0,-35,0,0,2,-7,28,0.28571
240,0,1,0,1,256,256,0.42857
480,8,0,1,3,458,450,0.85714
840,0,1,1,2,798,798,0.71429
480,5,0,1,2,471,466,0.71429
240,-1,0,1,3,224,225,0.85714
840,0,1,0,2,856,856,0.28571
240,17,0,1,2,233,216,0.71429
840,-11,0,0,1,808,819,0.42857
480,0,1,1,3,466,466,0.85714
840,24,0,1,4,832,808,1
840,0,1,1,4,823,823,1
0,-76,0,0,3,9,85,0.14286
240,-2,0,1,2,247,249,0.71429
0,11,0,1,4,29,18,1
840,0,1,1,1,867,867,0.57143
480,0,1,1,2,469,469,0.71429
840,14,0,0,1,846,832,0.42857
240,0,1,1,2,262,262,0.71429
240,-10,0,1,2,243,253,0.71429
840,0,1,0,1,832,832,0.42857
240,0,1,1,3,255,255,0.85714
240,0,1,1,3,261,261,0.85714
840,55,0,0,1,859,804,0.42857
480,0,1,0,1,497,497,0.42857
240,0,1,0,1,291,291,0.42857
840,-36,0,0,1,834,870,0.42857
0,0,1,1,3,-47,-47,0.85714
840,-15,0,0,1,826,841,0.42857
240,10,0,1,2,241,231,0.71429
840,-6,0,1,2,824,830,0.71429
840,8,0,1,1,847,839,0.57143
240,0,1,1,2,209,209,0.71429
0,0,1,1,4,-30,-30,1
240,0,1,1,4,216,216,1
0,20,0,1,4,23,3,1
840,5,0,1,2,841,836,0.71429
480,0,1,1,2,493,493,0.71429
840,34,0,1,1,888,854,0.57143
240,8,0,1,2,214,206,0.71429
240,-4,0,1,2,228,232,0.71429
240,15,0,0,1,233,218,0.42857
0,19,0,1,3,-39,-58,0.85714
840,9,0,1,2,852,843,0.71429
0,0,1,1,4,11,11,1
840,-11,0,1,1,840,851,0.57143
840,-103,0,0,2,787,890,0.28571
840,-3,0,0,2,826,829,0.28571
0,0,1,1,4,32,32,1
840,-43,0,0,2,828,871,0.28571
480,8,0,1,3,474,466,0.85714
240,0,1,1,3,271,271,0.85714
0,0,1,1,4,-16,-16,1
240,0,1,1,2,260,260,0.71429
480,0,1,1,4,454,454,1
240,0,1,1,4,218,218,1
0,9,0,1,4,-3,-12,1
840,-69,0,0,1,800,869,0.42857
840,-11,0,0,2,833,844,0.28571
480,0,1,1,1,490,490,0.57143
0,0,1,1,4,-12,-12,1
840,-51,0,1,2,814,865,0.71429
0,0,1,1,4,3,3,1
840,0,1,0,2,877,877,0.28571
480,0,1,1,4,475,475,1
240,0,1,1,4,233,233,1
0,53,0,0,4,44,-9,0
840,0,1,1,1,813,813,0.57143
240,0,1,1,4,206,206,1
0,0,1,1,4,-5,-5,1
840,4,0,1,1,823,819,0.57143
480,0,1,1,1,527,527,0.57143
240,-17,0,1,4,229,246,1
240,0,1,1,3,253,253,0.85714
480,0,1,1,4,452,452,1
240,0,1,1,4,262,262,1
240,-8,0,1,4,238,246,1
840,51,0,0,1,882,831,0.42857
480,24,0,0,2,514,490,0.28571
480,0,1,0,2,509,509,0.28571
0,-17,0,1,4,12,29,1
840,0,1,1,4,838,838,1
240,0,1,1,4,208,208,1
480,0,1,1,4,484,484,1
240,0,1,1,4,226,226,1
480,37,0,1,2,489,452,0.71429
840,3,0,1,4,866,863,1
480,0,1,1,4,512,512,1
240,-7,0,1,4,198,205,1
840,-74,0,0,1,811,885,0.42857
480,-24,0,1,1,472,496,0.57143
240,5,0,1,4,244,239,1
480,0,1,1,4,472,472,1
840,0,1,1,4,834,834,1
480,3,0,1,4,470,467,1
0,0,1,1,4,-9,-9,1
840,0,1,0,1,806,806,0.42857
0,0,1,1,4,-21,-21,1
480,0,1,1,2,522,522,0.71429
480,0,1,1,4,483,483,1
840,0,1,0,1,852,852,0.42857
0,0,1,1,4,45,45,1
0,12,0,0,3,12,0,0.14286
480,-28,0,1,4,461,489,1
840,0,1,1,1,865,865,0.57143
840,0,1,1,1,884,884,0.57143
240,0,1,0,1,306,306,0.42857
840,0,1,1,4,852,852,1
0,0,1,1,4,5,5,1
480,-20,0,1,4,461,481,1
240,0,1,1,4,291,291,1
0,0,1,1,4,-6,-6,1
480,-43,0,0,2,485,528,0.28571
480,0,1,0,2,467,467,0.28571
0,0,1,1,4,39,39,1
0,2,0,1,4,-15,-17,1
480,11,0,1,4,472,461,1
840,-37,0,0,2,825,862,0.28571
0,0,1,1,4,-32,-32,1
480,-25,0,1,2,493,518,0.71429
0,0,1,1,4,10,10,1
0,0,1,1,4,82,82,1
240,0,1,1,4,242,242,1
840,0,1,1,2,822,822,0.71429
240,-41,0,0,2,260,301,0.28571
480,0,1,0,3,486,486,0.14286
240,0,1,1,4,245,245,1
840,0,1,1,3,826,826,0.85714
0,0,1,1,4,-62,-62,1
240,-35,0,0,2,224,259,0.28571
840,9,0,0,2,849,840,0.28571
480,0,1,0,1,470,470,0.42857
480,0,1,1,4,490,490,1
480,-30,0,0,2,465,495,0.28571
0,51,0,0,4,4,-47,0
840,-31,0,0,4,851,882,0
0,0,1,1,4,-15,-15,1
840,0,1,0,3,833,833,0.14286
0,0,1,1,4,-33,-33,1
480,0,1,1,4,462,462,1
480,0,1,1,4,488,488,1
840,0,1,0,3,812,812,0.14286
240,0,1,1,4,229,229,1
0,0,1,1,4,-19,-19,1
840,15,0,0,2,870,855,0.28571
240,46,0,0,4,255,209,0
840,-16,0,0,3,845,861,0.14286
0,4,0,1,4,9,5,1
840,-23,0,0,2,828,851,0.28571
480,0,1,1,4,449,449,1
840,37,0,0,2,855,818,0.28571
480,0,1,0,2,518,518,0.28571
840,0,1,0,2,825,825,0.28571
240,0,1,1,4,242,242,1
480,0,1,1,4,471,471,1
480,0,1,1,4,479,479,1
0,0,1,1,4,13,13,1
0,0,1,1,4,-17,-17,1
840,0,1,1,4,815,815,1
0,2,0,0,2,26,24,0.28571
840,-24,0,0,1,819,843,0.42857
0,-5,0,1,4,-28,-23,1
0,14,0,1,3,-33,-47,0.85714
0,-13,0,0,2,-2,11,0.28571
0,-4,0,1,4,-25,-21,1
240,28,0,0,2,262,234,0.28571
480,0,1,0,2,484,484,0.28571
0,-13,0,0,3,3,16,0.14286
0,-3,0,1,4,-8,-5,1
0,10,0,0,3,12,2,0.14286
0,0,1,1,4,15,15,1
0,20,0,0,4,11,-9,0
240,0,1,1,3,257,257,0.85714
0,0,1,1,3,42,42,0.85714
480,0,1,1,4,501,501,1
840,26,0,1,4,844,818,1
0,0,1,1,4,-50,-50,1
240,0,1,1,4,237,237,1
480,22,0,0,3,490,468,0.14286
240,10,0,1,2,281,271,0.71429
0,3,0,1,4,7,4,1
480,61,0,0,2,505,444,0.28571
840,15,0,0,1,860,845,0.42857
240,57,0,0,4,276,219,0
480,0,1,1,4,441,441,1
0,26,0,1,4,10,-16,1
480,0,1,1,2,466,466,0.71429
480,24,0,1,2,482,458,0.71429
480,-74,0,0,4,441,515,0
480,0,1,1,3,526,526,0.85714
480,43,0,0,2,499,456,0.28571
840,-49,0,0,4,848,897,0
240,-5,0,0,2,240,245,0.28571
480,79,0,0,2,518,439,0.28571
480,0,1,1,2,465,465,0.71429
240,0,1,1,2,234,234,0.71429
240,27,0,0,3,263,236,0.14286
0,-23,0,1,4,-10,13,1
0,0,1,1,4,7,7,1
840,34,0,0,2,847,813,0.28571
0,-25,0,0,2,-10,15,0.28571
840,6,0,0,3,850,844,0.14286
840,0,1,1,2,853,853,0.71429
480,0,1,1,1,493,493,0.57143
840,-51,0,0,2,844,895,0.28571
480,-15,0,0,2,424,439,0.28571
480,-53,0,0,2,441,494,0.28571
480,42,0,0,2,499,457,0.28571
480,0,1,1,1,520,520,0.57143
240,-28,0,0,2,232,260,0.28571
0,0,1,1,4,1,1,1
480,0,1,1,4,436,436,1
240,0,1,1,4,204,204,1
0,-14,0,1,4,-7,7,1
840,9,0,0,2,868,859,0.28571
240,7,0,1,4,253,246,1
0,0,1,1,4,25,25,1
240,41,0,0,4,239,198,0
0,21,0,0,4,-5,-26,0
240,16,0,1,2,235,219,0.71429
480,73,0,0,4,546,473,0
0,-77,0,0,4,-44,33,0
0,0,1,1,2,31,31,0.71429
0,19,0,1,3,10,-9,0.85714
480,92,0,0,4,512,420,0
840,14,0,0,4,828,814,0
480,-89,0,0,4,406,495,0
840,0,1,1,2,791,791,0.71429
480,0,1,0,3,457,457,0.14286
840,0,1,1,4,843,843,1
0,0,1,1,4,8,8,1
840,-37,0,1,2,816,853,0.71429
840,0,1,1,2,868,868,0.71429
240,0,1,1,1,188,188,0.57143
240,-21,0,0,2,205,226,0.28571
480,-10,0,0,3,473,483,0.14286
240,38,0,0,3,259,221,0.14286
480,-50,0,0,2,497,547,0.28571
240,-41,0,0,3,238,279,0.14286
840,-6,0,1,1,859,865,0.57143
0,0,1,1,4,11,11,1
480,63,0,0,4,537,474,0
840,-25,0,0,3,817,842,0.14286
840,0,1,0,2,886,886,0.28571
240,0,1,1,2,202,202,0.71429
480,-36,0,0,3,457,493,0.14286
840,29,0,0,2,880,851,0.28571
840,0,1,0,1,830,830,0.42857
840,0,1,1,2,805,805,0.71429
0,45,0,0,4,16,-29,0
240,0,1,1,4,234,234,1
840,0,1,1,3,866,866,0.85714
240,0,1,1,2,233,233,0.71429
840,0,1,0,3,855,855,0.14286
0,0,1,1,4,-30,-30,1
0,0,1,1,4,-32,-32,1
480,0,1,1,4,486,486,1
240,-1,0,1,4,234,235,1
840,0,1,1,3,852,852,0.85714
240,-1,0,1,4,229,230,1
480,0,1,1,4,485,485,1
840,-19,0,1,4,831,850,1
240,0,1,1,4,239,239,1
480,56,0,0,2,508,452,0.28571
840,-21,0,0,3,808,829,0.14286
240,0,1,1,2,250,250,0.71429
840,-15,0,1,3,857,872,0.85714
480,0,1,1,4,478,478,1
840,0,1,1,4,817,817,1
0,-22,0,1,4,-29,-7,1
840,30,0,1,4,847,817,1
0,-30,0,0,3,-13,17,0.14286
480,23,0,1,4,480,457,1
480,0,1,1,4,498,498,1
240,-2,0,1,4,220,222,1
480,0,1,1,4,460,460,1
840,20,0,1,4,854,834,1
480,0,1,1,4,450,450,1
240,-38,0,0,3,206,244,0.14286
840,-23,0,0,2,844,867,0.28571
0,-10,0,0,1,-0,10,0.42857
480,0,1,0,3,466,466,0.14286
240,-55,0,0,3,217,272,0.14286
240,14,0,1,3,239,225,0.85714
0,0,1,1,4,-13,-13,1
840,11,0,0,2,860,849,0.28571
840,0,1,0,3,859,859,0.14286
0,-24,0,1,4,-14,10,1
0,12,0,1,4,18,6,1
840,1,0,0,3,835,834,0.14286
0,-45,0,0,4,-16,29,0
240,0,1,1,4,233,233,1
240,50,0,1,3,253,203,0.85714
480,0,1,0,2,488,488,0.28571
240,0,1,1,4,247,247,1
840,-46,0,0,1,822,868,0.42857
240,3,0,1,4,266,263,1
240,0,1,1,4,256,256,1
840,0,1,1,1,828,828,0.57143
0,38,0,0,4,9,-29,0
240,-33,0,1,4,251,284,1
480,0,1,1,4,460,460,1
0,-3,0,1,4,-12,-9,1
0,0,1,1,4,34,34,1
840,0,1,1,4,839,839,1
240,-5,0,1,3,203,208,0.85714
480,-28,0,1,4,518,546,1
0,-3,0,1,4,10,13,1
480,-4,0,1,4,441,445,1
480,0,1,1,4,505,505,1
840,0,1,1,4,841,841,1
240,-28,0,0,2,211,239,0.28571
840,0,1,0,1,842,842,0.42857
240,0,1,1,4,253,253,1
840,-20,0,1,2,821,841,0.71429
0,-9,0,1,4,8,17,1
240,0,1,1,4,232,232,1
480,85,0,0,3,537,452,0.14286
480,0,1,1,4,509,509,1
480,39,0,0,3,490,451,0.14286
0,0,1,1,4,2,2,1
0,0,1,1,4,-10,-10,1
0,-29,0,1,4,-38,-9,1
480,0,1,0,3,441,441,0.14286
480,18,0,1,4,480,462,1
840,0,1,1,4,845,845,1
840,0,1,1,4,828,828,1
480,-46,0,0,2,432,478,0.28571
240,-1,0,1,3,243,244,0.85714
840,0,1,1,1,856,856,0.57143
240,56,0,0,4,286,230,0
840,0,1,0,3,823,823,0.14286
480,0,1,1,4,502,502,1
240,0,1,1,4,261,261,1
480,67,0,0,4,518,451,0
480,-40,0,1,4,426,466,1
0,-18,0,1,4,-17,1,1
480,0,1,0,3,488,488,0.14286
0,-38,0,0,4,-19,19,0
480,0,1,1,3,482,482,0.85714
240,0,1,1,4,228,228,1
840,0,1,0,2,887,887,0.28571
480,1,0,0,3,476,475,0.14286
0,0,1,1,4,-6,-6,1
840,-86,0,0,4,825,911,0
840,3,0,0,3,844,841,0.14286
840,0,1,0,2,823,823,0.28571
240,0,1,1,4,253,253,1
0,0,1,1,4,-24,-24,1
0,0,1,1,4,-7,-7,1
0,0,1,1,4,7,7,1
840,0,1,0,1,833,833,0.42857
240,0,1,0,2,229,229,0.28571
0,-12,0,1,4,-35,-23,1
480,-74,0,0,4,440,514,0
240,0,1,1,4,244,244,1
0,0,1,1,4,-16,-16,1
840,-19,0,0,2,825,844,0.28571
480,19,0,0,2,489,470,0.28571
480,11,0,1,3,484,473,0.85714
240,-11,0,1,2,230,241,0.71429
840,0,1,1,4,833,833,1
480,0,1,1,2,485,485,0.71429
480,0,1,1,2,511,511,0.71429
480,-2,0,1,1,485,487,0.57143
480,0,1,1,1,445,445,0.57143
0,-17,0,1,4,2,19,1
840,6,0,1,3,830,824,0.85714
840,-11,0,1,2,836,847,0.71429
480,4,0,1,4,499,495,1
480,0,1,1,4,494,494,1
0,10,0,1,4,1,-9,1
240,0,1,1,4,243,243,1
480,-30,0,0,2,439,469,0.28571
0,0,1,1,4,8,8,1
840,29,0,0,2,876,847,0.28571
840,-10,0,0,1,834,844,0.42857
240,0,1,1,4,246,246,1
480,29,0,0,2,480,451,0.28571
240,38,0,0,2,283,245,0.28571
0,-11,0,1,4,-21,-10,1
840,-5,0,0,2,832,837,0.28571
240,0,1,0,2,269,269,0.28571
0,0,1,1,4,15,15,1
240,27,0,0,1,267,240,0.42857
240,-30,0,0,2,188,218,0.28571
480,11,0,1,4,470,459,1
240,0,1,1,2,234,234,0.71429
480,-23,0,1,3,497,520,0.85714
840,0,1,0,2,866,866,0.28571
480,0,1,1,4,468,468,1
0,2,0,1,4,10,8,1
840,0,1,0,1,833,833,0.42857
0,0,1,1,4,20,20,1
480,0,1,0,1,466,466,0.42857
240,15,0,0,1,230,215,0.42857
240,8,0,1,2,201,193,0.71429
240,-3,0,1,2,253,256,0.71429
0,0,1,1,4,-18,-18,1
240,0,1,1,4,246,246,1
840,0,1,1,2,858,858,0.71429
0,0,1,0,3,-39,-39,0.14286
480,-57,0,1,3,433,490,0.85714
240,-7,0,1,3,259,266,0.85714
840,0,1,1,4,829,829,1
240,22,0,0,2,242,220,0.28571
480,11,0,1,3,454,443,0.85714
480,-50,0,0,3,472,522,0.14286
480,0,1,0,2,466,466,0.28571
0,30,0,1,4,9,-21,1
840,-6,0,0,2,857,863,0.28571
0,0,1,1,4,-4,-4,1
240,10,0,1,4,239,229,1
840,0,1,0,2,819,819,0.28571
840,43,0,0,1,865,822,0.42857
840,0,1,0,2,859,859,0.28571
480,38,0,0,3,499,461,0.14286
840,0,1,1,2,828,828,0.71429
240,0,1,0,3,244,244,0.14286
840,0,1,0,3,883,883,0.14286
840,0,1,0,3,827,827,0.14286
480,8,0,1,2,501,493,0.71429
240,0,1,1,3,269,269,0.85714
840,17,0,1,1,864,847,0.57143
0,0,1,1,3,13,13,0.85714
840,0,1,1,2,845,845,0.71429
480,-4,0,1,2,493,497,0.71429
480,0,1,0,2,493,493,0.28571
0,-4,0,1,3,-10,-6,0.85714
240,0,1,1,3,247,247,0.85714
0,-14,0,1,4,-3,11,1
240,-9,0,1,4,218,227,1
840,0,1,0,2,867,867,0.28571
840,0,1,0,2,843,843,0.28571
840,0,1,0,2,833,833,0.28571
240,47,0,0,2,245,198,0.28571
480,0,1,1,2,455,455,0.71429
0,-25,0,1,3,13,38,0.85714
0,0,1,1,4,-20,-20,1
480,-21,0,0,2,473,494,0.28571
480,0,1,1,2,495,495,0.71429
480,59,0,0,4,546,487,0
240,0,1,1,1,225,225,0.57143
480,-37,0,0,2,452,489,0.28571
480,0,1,1,2,470,470,0.71429
0,-32,0,1,4,-38,-6,1
480,0,1,0,4,492,492,0
240,-20,0,0,4,277,297,0
240,0,1,1,2,268,268,0.71429
0,0,1,1,4,16,16,1
240,-55,0,0,3,231,286,0.14286
840,0,1,0,2,835,835,0.28571
840,-35,0,0,2,812,847,0.28571
840,0,1,1,2,847,847,0.71429
240,0,1,1,3,226,226,0.85714
240,-25,0,1,2,212,237,0.71429
840,3,0,1,2,808,805,0.71429
240,0,1,1,2,217,217,0.71429
840,0,1,0,2,834,834,0.28571
240,14,0,1,3,224,210,0.85714
240,9,0,1,3,253,244,0.85714
0,14,0,1,4,3,-11,1
480,0,1,1,2,461,461,0.71429
240,0,1,1,3,266,266,0.85714
840,0,1,1,2,811,811,0.71429
480,0,1,1,2,496,496,0.71429
0,21,0,1,4,-2,-23,1
840,0,1,1,4,805,805,1
480,0,1,1,3,461,461,0.85714
0,0,1,1,4,14,14,1
0,39,0,1,4,0,-39,1
480,0,1,0,2,514,514,0.28571
0,30,0,0,1,-14,-44,0.42857
0,50,0,0,1,10,-40,0.42857
0,0,1,1,4,34,34,1
240,0,1,1,4,228,228,1
840,50,0,0,1,866,816,0.42857
840,16,0,0,2,861,845,0.28571
240,87,0,0,4,287,200,0
0,0,1,1,4,-19,-19,1
0,30,0,0,4,46,16,0
480,5,0,0,1,487,482,0.42857
840,0,1,1,4,843,843,1
0,27,0,0,4,-9,-36,0
0,17,0,0,4,-4,-21,0
240,0,1,1,4,249,249,1
480,0,1,1,4,532,532,1
0,0,1,1,2,16,16,0.71429
0,0,1,1,4,8,8,1
480,12,0,1,2,470,458,0.71429
480,0,1,1,4,491,491,1
480,0,1,1,3,470,470,0.85714
480,-10,0,1,4,446,456,1
840,-8,0,1,4,828,836,1
0,-14,0,1,1,25,39,0.57143
0,16,0,1,1,-5,-21,0.57143
840,22,0,1,2,873,851,0.71429
480,33,0,0,1,481,448,0.42857
240,-12,0,0,2,250,262,0.28571
240,0,1,1,4,243,243,1
0,0,1,1,4,0,0,1
480,0,1,1,3,476,476,0.85714
240,0,1,1,3,214,214,0.85714
0,0,1,1,4,5,5,1
840,0,1,0,2,818,818,0.28571
0,-67,0,0,4,-21,46,0
480,-18,0,1,4,456,474,1
240,0,1,1,3,241,241,0.85714
240,0,1,1,2,241,241,0.71429
480,71,0,0,3,473,402,0.14286
840,0,1,0,2,828,828,0.28571
480,-22,0,0,2,477,499,0.28571
0,-33,0,0,1,-23,10,0.42857
480,0,1,0,3,490,490,0.14286
0,-8,0,0,2,1,9,0.28571
480,16,0,0,1,509,493,0.42857
840,-7,0,0,2,806,813,0.28571
480,20,0,0,2,485,465,0.28571
840,4,0,0,3,926,922,0.14286
480,0,1,1,2,471,471,0.71429
240,0,1,1,3,260,260,0.85714
480,-39,0,1,4,427,466,1
0,0,1,1,4,12,12,1
840,-25,0,0,2,826,851,0.28571
840,0,1,0,2,798,798,0.28571
240,0,1,1,3,260,260,0.85714
240,0,1,1,2,283,283,0.71429
0,18,0,0,2,-19,-37,0.28571
480,0,1,0,2,484,484,0.28571
0,0,1,1,3,10,10,0.85714
840,0,1,1,3,828,828,0.85714
840,0,1,1,2,851,851,0.71429
240,0,1,1,4,311,311,1
240,-50,0,0,2,217,267,0.28571
0,0,1,1,4,-11,-11,1
480,-20,0,1,3,455,475,0.85714
480,17,0,0,2,490,473,0.28571
0,22,0,0,3,15,-7,0.14286
480,0,1,1,2,493,493,0.71429
840,0,1,0,3,837,837,0.14286
840,0,1,1,1,821,821,0.57143
840,0,1,0,1,832,832,0.42857
0,-7,0,0,3,0,7,0.14286
840,0,1,0,2,806,806,0.28571
240,-45,0,0,3,226,271,0.14286
840,0,1,1,2,807,807,0.71429
840,-38,0,0,3,831,869,0.14286
480,-47,0,0,4,465,512,0
0,0,1,1,4,0,0,1
0,0,1,1,4,4,4,1
240,0,1,1,4,230,230,1
240,-68,0,0,4,178,246,0
840,22,0,0,2,855,833,0.28571
0,0,1,1,4,-7,-7,1
480,0,1,1,4,482,482,1
840,0,1,0,2,805,805,0.28571
480,35,0,0,3,513,478,0.14286
480,0,1,0,2,466,466,0.28571
0,0,1,1,4,33,33,1
840,16,0,1,4,834,818,1
0,36,0,0,4,13,-23,0
840,0,1,0,3,822,822,0.14286
0,0,1,1,4,-4,-4,1
840,0,1,0,2,846,846,0.28571
0,0,1,1,4,21,21,1
0,-31,0,1,4,15,46,1
840,-51,0,0,2,816,867,0.28571
480,0,1,1,4,515,515,1
480,26,0,0,2,486,460,0.28571
240,-18,0,1,4,223,241,1
480,0,1,1,4,492,492,1
0,1,0,1,4,29,28,1
840,0,1,0,2,835,835,0.28571
240,19,0,1,3,261,242,0.85714
480,0,1,0,2,475,475,0.28571
840,30,0,0,1,865,835,0.42857
840,-23,0,0,3,839,862,0.14286
0,-10,0,1,4,-19,-9,1
0,-89,0,0,4,-49,40,0
0,-7,0,0,4,-20,-13,0
840,-51,0,0,3,782,833,0.14286
840,0,1,0,2,850,850,0.28571
480,0,1,1,2,482,482,0.71429
240,32,0,0,3,261,229,0.14286
480,0,1,1,4,452,452,1
0,0,1,1,4,-11,-11,1
240,10,0,1,4,233,223,1
480,0,1,1,4,514,514,1
480,0,1,1,4,468,468,1
0,-34,0,0,2,4,38,0.28571
840,3,0,0,2,865,862,0.28571
0,0,1,1,4,-31,-31,1
840,28,0,0,1,845,817,0.42857
0,0,1,1,4,-35,-35,1
240,0,1,1,4,229,229,1
240,-17,0,0,2,246,263,0.28571
840,0,1,1,2,859,859,0.71429
240,0,1,1,4,224,224,1
480,0,1,1,4,494,494,1
840,1,0,1,3,823,822,0.85714
0,41,0,0,2,13,-28,0.28571
240,-68,0,0,4,223,291,0
0,0,1,1,4,-27,-27,1
0,0,1,1,4,22,22,1
840,19,0,1,2,884,865,0.71429
840,19,0,0,3,891,872,0.14286
0,0,1,1,4,9,9,1
240,-31,0,0,2,217,248,0.28571
480,64,0,0,4,500,436,0
480,0,1,0,1,477,477,0.42857
240,26,0,0,2,260,234,0.28571
240,-27,0,0,3,235,262,0.14286
840,-27,0,0,1,838,865,0.42857
480,22,0,1,4,452,430,1
0,-24,0,1,4,-46,-22,1
0,0,1,1,4,-30,-30,1
480,37,0,0,2,497,460,0.28571
840,0,1,0,2,844,844,0.28571
240,-7,0,1,4,214,221,1
480,-13,0,1,4,473,486,1
240,42,0,0,2,274,232,0.28571
840,0,1,0,3,852,852,0.14286
240,0,1,1,2,242,242,0.71429
480,11,0,1,3,546,535,0.85714
480,0,1,1,3,516,516,0.85714
0,-2,0,1,4,-12,-10,1
0,0,1,1,4,8,8,1
840,0,1,0,2,872,872,0.28571
0,24,0,0,3,42,18,0.14286
0,0,1,1,3,-8,-8,0.85714
840,0,1,0,2,856,856,0.28571
480,-63,0,0,3,457,520,0.14286
480,0,1,1,2,455,455,0.71429
240,-4,0,0,2,241,245,0.28571
240,64,0,0,4,251,187,0
240,-66,0,0,4,205,271,0
240,0,1,1,1,248,248,0.57143
480,0,1,1,4,467,467,1
480,0,1,1,4,490,490,1
240,0,1,1,3,270,270,0.85714
840,26,0,1,4,852,826,1
240,0,1,1,4,221,221,1
840,0,1,1,2,811,811,0.71429
480,22,0,0,2,490,468,0.28571
240,10,0,1,2,252,242,0.71429
840,-5,0,0,3,888,893,0.14286
480,12,0,0,2,465,453,0.28571
0,13,0,1,2,19,6,0.71429
840,33,0,0,3,839,806,0.14286
480,0,1,0,2,504,504,0.28571
840,-1,0,0,1,839,840,0.42857
480,-19,0,1,2,438,457,0.71429
0,-42,0,0,4,-30,12,0
240,0,1,1,3,223,223,0.85714
840,-12,0,1,2,844,856,0.71429
240,16,0,1,2,244,228,0.71429
240,0,1,0,2,259,259,0.28571
240,0,1,1,2,251,251,0.71429
240,0,1,0,2,231,231,0.28571
840,0,1,1,2,814,814,0.71429
840,16,0,0,2,801,785,0.28571
480,-2,0,0,3,473,475,0.14286
480,-7,0,1,2,454,461,0.71429
240,0,1,1,3,217,217,0.85714
840,0,1,0,2,838,838,0.28571
240,-8,0,0,1,247,255,0.42857
480,0,1,0,3,511,511,0.14286
0,0,1,1,3,7,7,0.85714
0,0,1,1,3,-10,-10,0.85714
480,0,1,0,2,521,521,0.28571
240,53,0,0,2,274,221,0.28571
840,0,1,1,3,836,836,0.85714
480,0,1,0,2,479,479,0.28571
240,0,1,1,3,263,263,0.85714
0,10,0,0,1,19,9,0.42857
480,0,1,1,2,499,499,0.71429
480,-41,0,0,2,452,493,0.28571
0,0,1,1,4,30,30,1
240,0,1,1,4,230,230,1
0,0,1,1,4,-36,-36,1
480,-84,0,0,2,433,517,0.28571
840,0,1,0,2,819,819,0.28571
480,45,0,0,3,481,436,0.14286
480,-37,0,0,1,437,474,0.42857
480,0,1,1,2,499,499,0.71429
840,0,1,0,3,831,831,0.14286
840,0,1,1,2,814,814,0.71429
240,-53,0,0,4,216,269,0
480,0,1,1,3,482,482,0.85714
480,0,1,1,4,472,472,1
480,6,0,0,2,498,492,0.28571
840,28,0,0,3,853,825,0.14286
480,-27,0,0,1,466,493,0.42857
0,0,1,1,4,14,14,1
240,-20,0,1,4,247,267,1
240,-7,0,0,2,233,240,0.28571
480,1,0,1,3,490,489,0.85714
240,0,1,1,2,253,253,0.71429
0,14,0,1,3,28,14,0.85714
240,0,1,1,4,239,239,1
0,0,1,1,3,63,63,0.85714
240,0,1,0,2,306,306,0.28571
240,0,1,1,3,232,232,0.85714
480,0,1,1,4,488,488,1
840,0,1,0,1,849,849,0.42857
0,0,1,1,3,3,3,0.85714
240,0,1,1,4,222,222,1
480,0,1,1,4,466,466,1
480,56,0,0,4,512,456,0
840,-18,0,0,4,808,826,0
240,0,1,1,1,208,208,0.57143
480,0,1,1,3,480,480,0.85714
480,0,1,1,4,481,481,1
0,0,1,1,3,-31,-31,0.85714
0,0,1,0,3,39,39,0.14286
0,-10,0,1,4,29,39,1
0,0,1,1,4,-34,-34,1
240,0,1,1,4,255,255,1
240,-6,0,1,4,223,229,1
480,0,1,1,4,484,484,1
480,0,1,1,2,516,516,0.71429
0,22,0,0,4,4,-18,0
840,55,0,0,2,887,832,0.28571
240,9,0,1,2,235,226,0.71429
0,-37,0,0,4,-21,16,0
240,0,1,1,2,231,231,0.71429
480,-11,0,0,3,450,461,0.14286
480,0,1,1,4,458,458,1
240,0,1,1,4,242,242,1
240,0,1,1,4,202,202,1
240,0,1,1,2,246,246,0.71429
240,-4,0,1,3,261,265,0.85714
0,0,1,1,4,12,12,1
480,0,1,1,4,480,480,1
840,0,1,0,2,874,874,0.28571
0,0,1,1,4,3,3,1
0,-26,0,0,2,-18,8,0.28571
480,-44,0,0,3,452,496,0.14286
840,20,0,0,4,882,862,0
840,0,1,1,3,835,835,0.85714
840,0,1,1,2,843,843,0.71429
840,-11,0,1,3,832,843,0.85714
480,36,0,0,4,525,489,0
480,-67,0,0,4,447,514,0
240,0,1,1,2,267,267,0.71429
240,0,1,0,2,260,260,0.28571
840,0,1,0,3,840,840,0.14286
0,0,1,1,3,-17,-17,0.85714
0,0,1,1,3,-6,-6,0.85714
840,0,1,0,2,851,851,0.28571
240,22,0,1,3,250,228,0.85714
840,17,0,0,2,865,848,0.28571
240,-5,0,1,3,228,233,0.85714
0,16,0,1,2,-23,-39,0.71429
840,0,1,0,2,882,882,0.28571
480,48,0,0,4,497,449,0
0,0,1,1,4,16,16,1
840,0,1,1,4,854,854,1
0,0,1,1,3,-19,-19,0.85714
480,0,1,1,4,441,441,1
240,0,1,1,4,184,184,1
0,0,1,1,4,57,57,1
840,0,1,0,2,803,803,0.28571
0,3,0,1,4,-4,-7,1
240,-17,0,0,2,191,208,0.28571
0,-25,0,0,4,-21,4,0
0,36,0,0,4,17,-19,0
0,-15,0,1,2,-24,-9,0.71429
0,-11,0,1,3,-30,-19,0.85714
240,9,0,0,2,222,213,0.28571
240,0,1,1,3,290,290,0.85714
480,14,0,0,2,529,515,0.28571
0,-37,0,0,2,-14,23,0.28571
240,23,0,0,2,242,219,0.28571
0,22,0,0,1,-9,-31,0.42857
240,0,1,1,2,232,232,0.71429
480,2,0,0,3,470,468,0.14286
840,0,1,0,3,832,832,0.14286
0,0,1,1,4,-16,-16,1
240,0,1,1,3,236,236,0.85714
480,69,0,0,3,537,468,0.14286
240,0,1,1,3,231,231,0.85714
480,0,1,1,2,502,502,0.71429
840,35,0,1,3,834,799,0.85714
840,12,0,1,3,873,861,0.85714
240,4,0,1,3,238,234,0.85714
0,14,0,1,2,48,34,0.71429
840,18,0,0,2,851,833,0.28571
240,0,1,1,3,214,214,0.85714
0,0,1,1,3,55,55,0.85714
240,56,0,0,3,244,188,0.14286
240,0,1,1,2,278,278,0.71429
0,17,0,1,3,15,-2,0.85714
240,-30,0,0,2,239,269,0.28571
480,0,1,0,3,479,479,0.14286
840,51,0,0,4,884,833,0
240,-9,0,0,2,224,233,0.28571
0,-3,0,1,4,-14,-11,1
480,1,0,1,4,475,474,1
0,0,1,1,4,-23,-23,1
240,0,1,0,2,225,225,0.28571
840,21,0,0,2,863,842,0.28571
840,-21,0,0,2,845,866,0.28571
480,0,1,1,4,456,456,1
0,68,0,0,4,20,-48,0
240,-14,0,0,3,223,237,0.14286
240,0,1,0,2,251,251,0.28571
840,0,1,0,3,817,817,0.14286
480,-1,0,1,3,511,512,0.85714
840,-10,0,0,2,840,850,0.28571
240,13,0,0,2,219,206,0.28571
0,0,1,1,4,12,12,1
840,0,1,1,2,841,841,0.71429
0,0,1,1,4,-44,-44,1
240,52,0,0,4,259,207,0
0,0,1,1,4,-13,-13,1
840,-5,0,0,2,830,835,0.28571
0,51,0,0,4,28,-23,0
0,0,1,1,4,-26,-26,1
840,18,0,0,2,862,844,0.28571
480,9,0,1,1,484,475,0.57143
0,47,0,0,4,48,1,0
480,9,0,1,4,478,469,1
240,-15,0,0,2,218,233,0.28571
480,0,1,1,4,458,458,1
0,15,0,1,3,13,-2,0.85714
840,39,0,1,2,840,801,0.71429
0,17,0,1,4,-29,-46,1
0,-14,0,1,4,1,15,1
0,0,1,1,4,64,64,1
0,0,1,1,4,-14,-14,1
240,0,1,1,4,259,259,1
480,0,1,1,4,490,490,1
840,0,1,1,2,869,869,0.71429
0,-10,0,1,4,1,11,1
840,-2,0,0,2,853,855,0.28571
840,-57,0,0,2,815,872,0.28571
0,-22,0,0,2,-16,6,0.28571
240,-12,0,0,1,238,250,0.42857
240,-5,0,1,4,226,231,1
480,0,1,1,3,457,457,0.85714
480,3,0,1,2,468,465,0.71429
240,0,1,1,4,252,252,1
480,0,1,1,4,451,451,1
480,-32,0,0,2,479,511,0.28571
240,14,0,1,4,239,225,1
480,0,1,1,4,485,485,1
840,7,0,0,2,818,811,0.28571
240,35,0,0,2,291,256,0.28571
0,0,1,1,3,38,38,0.85714
480,0,1,1,2,511,511,0.71429
480,0,1,1,4,490,490,1
240,0,1,1,4,260,260,1
480,0,1,1,4,473,473,1
480,-51,0,0,2,487,538,0.28571
480,-22,0,0,2,489,511,0.28571
480,0,1,0,2,470,470,0.28571
840,-56,0,0,3,780,836,0.14286
0,0,1,1,2,44,44,0.71429
840,93,0,0,4,901,808,0
840,-24,0,0,3,832,856,0.14286
840,0,1,1,4,860,860,1
480,-6,0,0,2,468,474,0.28571
240,0,1,1,2,218,218,0.71429
840,0,1,1,1,766,766,0.57143
240,-16,0,1,2,234,250,0.71429
240,12,0,1,3,262,250,0.85714
480,-11,0,0,2,460,471,0.28571
0,19,0,1,4,11,-8,1
840,0,1,0,3,832,832,0.14286
840,-59,0,0,4,827,886,0
240,0,1,1,2,233,233,0.71429
480,36,0,0,3,502,466,0.14286
840,0,1,1,2,818,818,0.71429
0,-28,0,0,4,-18,10,0
840,-30,0,0,2,855,885,0.28571
240,0,1,0,3,248,248,0.14286
480,-2,0,1,2,477,479,0.71429
840,38,0,0,4,858,820,0
480,44,0,0,4,508,464,0
840,0,1,0,2,803,803,0.28571
840,-49,0,0,3,804,853,0.14286
480,3,0,1,2,484,481,0.71429
0,88,0,0,4,85,-3,0
240,0,1,1,2,186,186,0.71429
840,31,0,1,3,853,822,0.85714
240,0,1,1,3,258,258,0.85714
480,-17,0,0,2,486,503,0.28571
840,-27,0,1,2,823,850,0.71429
840,27,0,1,3,848,821,0.85714
240,0,1,1,2,268,268,0.71429
240,-37,0,0,3,194,231,0.14286
840,-50,0,0,4,809,859,0
240,0,1,1,4,231,231,1
240,0,1,1,4,225,225,1
0,-6,0,1,4,12,18,1
840,-2,0,1,2,857,859,0.71429
0,13,0,0,3,7,-6,0.14286
0,-43,0,0,3,-18,25,0.14286
480,-26,0,1,4,483,509,1
480,0,1,1,4,484,484,1
840,0,1,1,2,841,841,0.71429
480,-37,0,0,2,446,483,0.28571
840,0,1,0,1,838,838,0.42857
840,0,1,1,3,863,863,0.85714
840,-32,0,1,2,803,835,0.71429
480,-51,0,0,2,434,485,0.28571
840,0,1,1,2,846,846,0.71429
240,50,0,0,4,303,253,0
240,0,1,0,2,278,278,0.28571
240,30,0,1,2,255,225,0.71429
840,0,1,1,4,832,832,1
240,0,1,1,4,235,235,1
480,0,1,0,2,497,497,0.28571
0,-2,0,1,4,2,4,1
240,0,1,1,4,253,253,1
480,20,0,0,2,505,485,0.28571
0,0,1,1,4,17,17,1
840,30,0,0,2,872,842,0.28571
840,0,1,0,2,826,826,0.28571
0,-14,0,1,4,-33,-19,1
0,-36,0,0,3,-42,-6,0.14286
0,0,1,1,4,3,3,1
240,24,0,1,4,277,253,1
0,0,1,1,4,4,4,1
840,0,1,1,2,865,865,0.71429
240,0,1,1,1,251,251,0.57143
840,0,1,1,3,907,907,0.85714
0,-25,0,1,4,-7,18,1
840,-44,0,0,2,806,850,0.28571
480,-9,0,0,2,454,463,0.28571
240,0,1,1,4,216,216,1
240,0,1,1,4,236,236,1
240,0,1,1,4,204,204,1
0,0,1,1,4,-4,-4,1
240,37,0,0,3,238,201,0.14286
840,0,1,1,4,837,837,1
840,-26,0,1,2,805,831,0.71429
0,0,1,1,4,-33,-33,1
0,26,0,1,4,40,14,1
0,0,1,1,4,10,10,1
840,0,1,0,2,801,801,0.28571
0,0,1,1,4,-7,-7,1
0,0,1,1,4,-28,-28,1
840,0,1,1,2,813,813,0.71429
480,0,1,1,4,497,497,1
0,0,1,1,4,-53,-53,1
840,-51,0,0,2,808,859,0.28571
840,-13,0,0,3,842,855,0.14286
480,0,1,1,4,446,446,1
0,49,0,0,4,27,-22,0
240,-6,0,1,2,209,215,0.71429
840,15,0,0,1,855,840,0.42857
480,0,1,1,2,480,480,0.71429
240,0,1,1,3,244,244,0.85714
480,0,1,1,2,471,471,0.71429
840,0,1,0,2,848,848,0.28571
480,-25,0,1,4,456,481,1
480,-35,0,0,3,455,490,0.14286
840,0,1,0,2,831,831,0.28571
240,-41,0,0,4,214,255,0
0,0,1,1,2,41,41,0.71429
480,0,1,0,3,490,490,0.14286
480,0,1,1,2,479,479,0.71429
840,0,1,0,2,780,780,0.28571
0,0,1,1,4,-52,-52,1
240,-1,0,1,4,230,231,1
240,10,0,1,4,257,247,1
0,-9,0,1,4,15,24,1
840,-60,0,0,2,825,885,0.28571
240,-62,0,0,3,209,271,0.14286
0,15,0,0,3,31,16,0.14286
240,-41,0,0,3,239,280,0.14286
480,0,1,0,3,510,510,0.14286
840,9,0,1,2,859,850,0.71429
240,0,1,1,2,251,251,0.71429
0,0,1,1,3,-13,-13,0.85714
480,0,1,1,2,466,466,0.71429
0,-48,0,0,3,-36,12,0.14286
240,-8,0,1,3,246,254,0.85714
240,-2,0,1,2,248,250,0.71429
240,-14,0,1,3,202,216,0.85714
840,0,1,1,3,798,798,0.85714
240,0,1,1,3,242,242,0.85714
0,0,1,1,3,-4,-4,0.85714
840,10,0,1,4,843,833,1
840,3,0,1,4,835,832,1
840,0,1,1,2,837,837,0.71429
840,0,1,0,2,814,814,0.28571
840,0,1,1,2,793,793,0.71429
480,42,0,0,3,511,469,0.14286
0,19,0,0,3,30,11,0.14286
0,0,1,1,3,-16,-16,0.85714
240,18,0,1,3,250,232,0.85714
0,36,0,0,2,26,-10,0.28571
480,-47,0,0,4,465,512,0
0,0,1,1,2,-5,-5,0.71429
240,0,1,1,2,222,222,0.71429
480,0,1,1,2,471,471,0.71429
0,38,0,0,4,15,-23,0
240,-1,0,1,3,253,254,0.85714
480,0,1,1,3,494,494,0.85714
840,0,1,1,3,835,835,0.85714
0,0,1,1,3,41,41,0.85714
240,0,1,1,3,236,236,0.85714
240,44,0,0,3,284,240,0.14286
0,0,1,1,3,10,10,0.85714
240,0,1,1,3,239,239,0.85714
840,7,0,0,3,847,840,0.14286
480,0,1,1,2,474,474,0.71429
0,52,0,0,4,6,-46,0
0,0,1,1,3,-16,-16,0.85714
480,-36,0,0,2,469,505,0.28571
0,-5,0,1,2,-12,-7,0.71429
240,0,1,1,3,226,226,0.85714
0,0,1,1,3,-21,-21,0.85714
0,-13,0,1,3,-2,11,0.85714
840,-8,0,0,3,849,857,0.14286
240,-17,0,0,2,252,269,0.28571
240,-19,0,0,2,231,250,0.28571
480,0,1,1,2,495,495,0.71429
840,-27,0,0,3,799,826,0.14286
480,68,0,0,3,516,448,0.14286
480,0,1,1,2,468,468,0.71429
480,0,1,1,2,480,480,0.71429
0,-55,0,0,4,-40,15,0
840,-28,0,0,4,829,857,0
240,7,0,0,3,232,225,0.14286
0,0,1,1,3,9,9,0.85714
840,0,1,1,2,843,843,0.71429
480,-17,0,0,3,473,490,0.14286
480,-9,0,0,3,463,472,0.14286
840,-8,0,1,2,813,821,0.71429
840,41,0,0,2,874,833,0.28571
480,0,1,1,2,490,490,0.71429
240,0,1,0,1,251,251,0.42857
240,18,0,0,2,243,225,0.28571
480,0,1,0,1,462,462,0.42857
240,-41,0,0,1,235,276,0.42857
240,-32,0,0,1,202,234,0.42857
0,-35,0,0,2,20,55,0.28571
840,58,0,0,2,889,831,0.28571
840,0,1,0,2,863,863,0.28571
0,0,1,1,3,-53,-53,0.85714
840,0,1,1,2,821,821,0.71429
0,16,0,0,1,8,-8,0.42857
240,9,0,1,2,254,245,0.71429
480,0,1,1,2,486,486,0.71429
0,33,0,0,2,0,-33,0.28571
0,0,1,1,3,-2,-2,0.85714
0,0,1,1,3,12,12,0.85714
480,-35,0,0,1,462,497,0.42857
840,0,1,0,1,856,856,0.42857
840,48,0,0,2,870,822,0.28571
840,-67,0,0,2,772,839,0.28571
480,0,1,0,3,507,507,0.14286
0,0,1,0,1,28,28,0.42857
0,-29,0,0,2,-30,-1,0.28571
480,0,1,1,2,498,498,0.71429
240,-12,0,0,2,227,239,0.28571
480,-45,0,0,2,459,504,0.28571
480,43,0,0,2,519,476,0.28571
0,-10,0,0,2,-27,-17,0.28571
480,0,1,1,2,506,506,0.71429
240,-45,0,0,2,241,286,0.28571
240,58,0,0,3,297,239,0.14286
840,-12,0,0,2,861,873,0.28571
0,0,1,0,1,-28,-28,0.42857
0,0,1,1,2,-20,-20,0.71429
240,-1,0,1,2,254,255,0.71429
480,19,0,0,1,485,466,0.42857
0,-8,0,0,2,-4,4,0.28571
480,12,0,0,2,489,477,0.28571
480,48,0,0,2,488,440,0.28571
480,-45,0,0,2,455,500,0.28571
0,0,1,0,1,0,0,0.42857
240,0,1,1,2,232,232,0.71429
0,-44,0,0,2,6,50,0.28571
480,44,0,0,1,518,474,0.42857
0,0,1,0,2,-7,-7,0.28571
0,0,1,1,2,-56,-56,0.71429
0,0,1,1,2,33,33,0.71429
840,-29,0,0,2,842,871,0.28571
480,-41,0,0,1,449,490,0.42857
480,-10,0,1,2,483,493,0.71429
480,49,0,0,3,521,472,0.14286
840,10,0,0,1,852,842,0.42857
240,-57,0,0,2,209,266,0.28571
480,30,0,0,3,536,506,0.14286
480,0,1,1,3,486,486,0.85714
0,-71,0,0,2,-28,43,0.28571
240,0,1,1,2,218,218,0.71429
0,74,0,0,3,21,-53,0.14286
0,0,1,1,2,45,45,0.71429
840,0,1,0,2,845,845,0.28571
840,0,1,0,2,858,858,0.28571
840,-58,0,0,1,822,880,0.42857
240,0,1,1,2,247,247,0.71429
840,0,1,1,3,893,893,0.85714
240,0,1,0,2,215,215,0.28571
240,0,1,1,4,249,249,1
240,0,1,1,4,250,250,1
840,32,0,0,1,860,828,0.42857
0,0,1,0,1,-6,-6,0.42857
840,0,1,1,3,895,895,0.85714
0,-8,0,1,2,6,14,0.71429
240,0,1,1,4,190,190,1
840,-9,0,1,4,837,846,1
240,-11,0,1,3,256,267,0.85714
240,-33,0,0,1,216,249,0.42857
240,0,1,1,2,283,283,0.71429
480,0,1,1,3,462,462,0.85714
480,0,1,1,3,472,472,0.85714
240,-6,0,1,3,250,256,0.85714
480,31,0,0,2,501,470,0.28571
480,-38,0,1,3,487,525,0.85714
240,0,1,1,3,257,257,0.85714
0,16,0,1,4,21,5,1
480,-23,0,1,2,449,472,0.71429
840,0,1,0,1,839,839,0.42857
480,0,1,1,2,493,493,0.71429
840,0,1,1,2,825,825,0.71429
0,0,1,0,1,-40,-40,0.42857
0,0,1,1,3,-1,-1,0.85714
480,-55,0,0,1,472,527,0.42857
0,-46,0,0,2,-38,8,0.28571
240,0,1,1,4,227,227,1
240,0,1,1,4,214,214,1
240,21,0,0,1,278,257,0.42857
0,0,1,0,2,42,42,0.28571
240,0,1,1,4,211,211,1
240,50,0,1,3,247,197,0.85714
0,0,1,1,3,16,16,0.85714
840,61,0,1,4,885,824,1
480,44,0,0,2,507,463,0.28571
240,0,1,0,2,212,212,0.28571
840,-23,0,1,2,841,864,0.71429
480,-34,0,0,1,460,494,0.42857
840,0,1,0,1,847,847,0.42857
240,0,1,1,4,243,243,1
840,0,1,0,1,832,832,0.42857
480,0,1,1,3,475,475,0.85714
480,-4,0,1,3,484,488,0.85714
840,0,1,1,3,847,847,0.85714
840,0,1,1,2,858,858,0.71429
0,-2,0,1,4,-12,-10,1
480,0,1,1,4,500,500,1
0,-44,0,0,1,-21,23,0.42857
840,0,1,1,3,866,866,0.85714
240,28,0,1,3,276,248,0.85714
480,0,1,1,3,519,519,0.85714
240,-12,0,1,3,257,269,0.85714
480,0,1,1,3,474,474,0.85714
240,69,0,0,2,286,217,0.28571
0,0,1,1,4,18,18,1
840,0,1,0,2,829,829,0.28571
480,0,1,1,3,485,485,0.85714
840,-34,0,1,2,812,846,0.71429
840,8,0,1,1,854,846,0.57143
0,0,1,1,3,10,10,0.85714
0,0,1,1,4,1,1,1
480,27,0,0,1,509,482,0.42857
0,0,1,1,4,19,19,1
240,-51,0,0,1,227,278,0.42857
840,15,0,1,2,829,814,0.71429
240,0,1,1,3,254,254,0.85714
480,0,1,1,3,512,512,0.85714
240,0,1,1,4,222,222,1
480,-5,0,1,3,465,470,0.85714
840,-27,0,0,2,799,826,0.28571
840,0,1,1,2,840,840,0.71429
0,50,0,0,3,3,-47,0.14286
480,0,1,1,3,485,485,0.85714
0,-14,0,1,4,-14,-0,1
480,59,0,0,2,501,442,0.28571
0,0,1,1,4,-10,-10,1
840,-12,0,0,1,852,864,0.42857
240,0,1,1,4,239,239,1
480,0,1,1,4,473,473,1
840,0,1,0,1,862,862,0.42857
240,5,0,1,3,227,222,0.85714
240,0,1,1,4,267,267,1
480,-56,0,0,2,440,496,0.28571
0,0,1,1,4,9,9,1
480,0,1,1,4,428,428,1
840,18,0,0,2,845,827,0.28571
240,0,1,1,3,223,223,0.85714
840,-8,0,0,1,870,878,0.42857
0,0,1,1,4,-32,-32,1
240,0,1,1,3,270,270,0.85714
0,-2,0,1,4,-30,-28,1
840,0,1,0,1,837,837,0.42857
240,0,1,1,4,246,246,1
0,0,1,1,4,-14,-14,1
0,-35,0,0,2,-49,-14,0.28571
840,0,1,1,2,870,870,0.71429
0,0,1,1,4,-6,-6,1
240,0,1,0,1,265,265,0.42857
480,0,1,0,1,483,483,0.42857
0,0,1,1,3,9,9,0.85714
0,81,0,1,4,14,-67,1
840,0,1,0,1,807,807,0.42857
0,0,1,1,2,24,24,0.71429
0,0,1,1,3,-9,-9,0.85714
840,31,0,0,1,864,833,0.42857
240,0,1,1,2,183,183,0.71429
0,4,0,1,4,-7,-11,1
480,-15,0,0,1,468,483,0.42857
840,-32,0,0,2,847,879,0.28571
240,-39,0,0,2,197,236,0.28571
240,0,1,1,2,254,254,0.71429
240,0,1,1,2,230,230,0.71429
0,0,1,1,3,4,4,0.85714
240,15,0,1,4,253,238,1
240,0,1,1,2,212,212,0.71429
480,25,0,0,1,510,485,0.42857
0,11,0,0,1,20,9,0.42857
0,22,0,0,1,23,1,0.42857
480,-7,0,1,3,483,490,0.85714
240,41,0,0,2,264,223,0.28571
840,50,0,0,2,858,808,0.28571
840,51,0,0,1,894,843,0.42857
240,0,1,1,2,202,202,0.71429
840,10,0,1,1,812,802,0.57143
840,0,1,0,1,804,804,0.42857
240,-18,0,1,2,240,258,0.71429
480,0,1,1,3,470,470,0.85714
0,0,1,1,2,-15,-15,0.71429
240,52,0,0,2,274,222,0.28571
480,0,1,1,2,510,510,0.71429
480,70,0,0,2,519,449,0.28571
840,24,0,0,3,833,809,0.14286
840,-17,0,1,2,792,809,0.71429
0,38,0,0,2,21,-17,0.28571
840,-11,0,1,1,840,851,0.57143
480,0,1,1,3,463,463,0.85714
240,15,0,1,2,256,241,0.71429
0,12,0,0,1,5,-7,0.42857
0,-65,0,0,2,-43,22,0.28571
0,54,0,0,3,29,-25,0.14286
0,7,0,0,2,10,3,0.28571
480,0,1,1,2,510,510,0.71429
840,0,1,1,3,850,850,0.85714
840,0,1,0,1,838,838,0.42857
240,17,0,0,1,254,237,0.42857
0,37,0,0,2,36,-1,0.28571
840,28,0,1,2,867,839,0.71429
240,0,1,1,3,231,231,0.85714
480,3,0,1,2,496,493,0.71429
480,0,1,1,3,439,439,0.85714
480,0,1,1,4,477,477,1
0,0,1,1,4,10,10,1
0,7,0,1,3,31,24,0.85714
840,33,0,0,1,871,838,0.42857
0,0,1,1,3,7,7,0.85714
0,-25,0,0,2,-30,-5,0.28571
0,0,1,1,2,-28,-28,0.71429
0,0,1,1,3,-53,-53,0.85714
480,23,0,0,1,496,473,0.42857
0,0,1,1,3,-21,-21,0.85714
480,19,0,0,1,529,510,0.42857
0,0,1,1,3,-19,-19,0.85714
0,59,0,1,4,46,-13,1
0,0,1,1,4,-13,-13,1
240,0,1,1,3,233,233,0.85714
480,0,1,1,2,455,455,0.71429
240,0,1,1,2,232,232,0.71429
480,51,0,0,2,462,411,0.28571
480,0,1,1,3,457,457,0.85714
840,-66,0,0,2,797,863,0.28571
480,0,1,1,2,500,500,0.71429
840,0,1,1,4,838,838,1
0,26,0,0,2,-4,-30,0.28571
480,0,1,1,3,491,491,0.85714
840,-2,0,0,1,846,848,0.42857
480,0,1,1,2,475,475,0.71429
840,0,1,1,1,834,834,0.57143
240,0,1,1,2,267,267,0.71429
840,0,1,0,1,840,840,0.42857
840,15,0,0,1,827,812,0.42857
240,19,0,1,2,280,261,0.71429
480,28,0,0,2,493,465,0.28571
240,9,0,1,2,223,214,0.71429
480,-5,0,0,2,508,513,0.28571
0,41,0,0,3,14,-27,0.14286
840,0,1,0,2,796,796,0.28571
240,-37,0,0,2,224,261,0.28571
840,41,0,0,3,861,820,0.14286
840,0,1,1,2,816,816,0.71429
840,-6,0,0,1,832,838,0.42857
240,14,0,0,2,257,243,0.28571
480,25,0,0,2,479,454,0.28571
240,0,1,1,2,222,222,0.71429
240,0,1,1,2,239,239,0.71429
840,10,0,1,3,860,850,0.85714
480,42,0,0,2,473,431,0.28571
0,-3,0,0,2,13,16,0.28571
240,0,1,1,2,220,220,0.71429
480,0,1,1,3,462,462,0.85714
240,41,0,0,3,233,192,0.14286
840,-27,0,0,2,839,866,0.28571
480,-1,0,0,2,471,472,0.28571
0,0,1,1,2,-15,-15,0.71429
480,0,1,1,3,470,470,0.85714
0,48,0,0,3,13,-35,0.14286
240,0,1,1,3,247,247,0.85714
840,-10,0,1,4,821,831,1
480,0,1,0,2,457,457,0.28571
480,0,1,0,1,502,502,0.42857
840,23,0,1,3,868,845,0.85714
840,25,0,0,2,865,840,0.28571
240,-9,0,1,3,257,266,0.85714
240,0,1,1,4,240,240,1
480,0,1,1,4,421,421,1
0,18,0,1,4,-17,-35,1
0,0,1,0,1,31,31,0.42857
240,0,1,1,4,274,274,1
840,0,1,1,4,826,826,1
480,24,0,0,2,504,480,0.28571
0,-67,0,0,2,-58,9,0.28571
480,0,1,0,2,455,455,0.28571
480,9,0,1,2,466,457,0.71429
840,20,0,1,3,891,871,0.85714
480,0,1,1,3,438,438,0.85714
480,2,0,1,3,475,473,0.85714
0,62,0,0,3,21,-41,0.14286
840,0,1,0,3,836,836,0.14286
840,0,1,0,2,819,819,0.28571
840,0,1,1,1,849,849,0.57143
840,12,0,1,4,839,827,1
840,0,1,1,3,857,857,0.85714
0,-6,0,1,3,11,17,0.85714
840,0,1,1,2,812,812,0.71429
840,-17,0,0,1,823,840,0.42857
0,-22,0,0,3,-31,-9,0.14286
840,16,0,1,3,839,823,0.85714
840,-7,0,1,2,845,852,0.71429
480,58,0,0,3,527,469,0.14286
240,0,1,1,3,226,226,0.85714
240,23,0,0,2,242,219,0.28571
0,-38,0,0,1,-22,16,0.42857
240,0,1,1,3,216,216,0.85714
480,0,1,1,2,430,430,0.71429
240,0,1,1,2,237,237,0.71429
0,0,1,1,3,-20,-20,0.85714
840,-18,0,0,1,845,863,0.42857
240,0,1,1,2,242,242,0.71429
0,0,1,1,3,22,22,0.85714
0,0,1,0,2,22,22,0.28571
480,69,0,0,3,540,471,0.14286
480,0,1,0,3,485,485,0.14286
240,-30,0,0,3,202,232,0.14286
240,-68,0,0,3,197,265,0.14286
480,71,0,0,3,509,438,0.14286
480,0,1,0,2,481,481,0.28571
240,-5,0,1,2,253,258,0.71429
0,0,1,1,3,-8,-8,0.85714
240,30,0,0,3,242,212,0.14286
240,0,1,1,2,223,223,0.71429
0,0,1,1,2,20,20,0.71429
840,0,1,0,2,855,855,0.28571
240,-2,0,1,2,245,247,0.71429
240,-12,0,0,1,225,237,0.42857
840,-8,0,0,2,877,885,0.28571
0,-16,0,0,3,-14,2,0.14286
480,-27,0,1,2,462,489,0.71429
240,0,1,0,1,231,231,0.42857
0,13,0,1,3,-4,-17,0.85714
240,-23,0,0,3,240,263,0.14286
480,0,1,1,2,491,491,0.71429
240,0,1,0,2,262,262,0.28571
240,0,1,0,1,229,229,0.42857
840,0,1,1,3,820,820,0.85714
480,0,1,1,3,446,446,0.85714
480,0,1,0,2,490,490,0.28571
240,-23,0,0,2,256,279,0.28571
480,0,1,1,2,512,512,0.71429
840,28,0,1,3,833,805,0.85714
240,0,1,1,4,195,195,1
840,0,1,0,2,854,854,0.28571
240,25,0,1,2,253,228,0.71429
480,26,0,0,2,472,446,0.28571
480,0,1,0,2,478,478,0.28571
0,-31,0,0,2,2,33,0.28571
240,-41,0,0,3,212,253,0.14286
840,56,0,0,3,891,835,0.14286
0,0,1,1,2,-47,-47,0.71429
480,17,0,0,2,479,462,0.28571
0,0,1,1,2,-22,-22,0.71429
480,0,1,0,2,514,514,0.28571
0,0,1,1,4,8,8,1
480,0,1,0,2,478,478,0.28571
0,0,1,1,3,-18,-18,0.85714
480,16,0,0,1,502,486,0.42857
840,0,1,0,1,840,840,0.42857
240,0,1,1,3,245,245,0.85714
0,22,0,0,1,9,-13,0.42857
240,-24,0,0,2,213,237,0.28571
0,0,1,1,3,5,5,0.85714
0,18,0,0,1,-2,-20,0.42857
840,-7,0,0,2,846,853,0.28571
480,0,1,1,4,477,477,1
840,0,1,0,1,876,876,0.42857
840,0,1,0,1,812,812,0.42857
240,-45,0,0,2,252,297,0.28571
480,71,0,0,2,516,445,0.28571
840,-3,0,0,3,826,829,0.14286
840,30,0,0,2,864,834,0.28571
240,31,0,0,2,230,199,0.28571
240,19,0,0,3,235,216,0.14286
0,32,0,0,3,-2,-34,0.14286
240,-25,0,0,2,207,232,0.28571
0,40,0,0,3,46,6,0.14286
0,-15,0,0,2,26,41,0.28571
840,0,1,1,2,862,862,0.71429
240,0,1,0,2,255,255,0.28571
480,0,1,1,1,506,506,0.57143
240,0,1,1,3,243,243,0.85714
480,-60,0,0,2,461,521,0.28571
480,-11,0,1,3,442,453,0.85714
480,0,1,0,2,469,469,0.28571
840,14,0,0,3,864,850,0.14286
840,0,1,0,2,833,833,0.28571
840,15,0,0,2,838,823,0.28571
480,0,1,0,2,473,473,0.28571
480,0,1,1,2,448,448,0.71429
0,54,0,0,3,29,-25,0.14286
240,0,1,1,2,237,237,0.71429
0,-11,0,1,3,9,20,0.85714
480,6,0,0,1,469,463,0.42857
840,-72,0,0,2,842,914,0.28571
0,-9,0,1,3,12,21,0.85714
240,0,1,1,2,250,250,0.71429
0,0,1,1,4,27,27,1
840,0,1,1,2,857,857,0.71429
840,0,1,1,3,864,864,0.85714
840,-54,0,0,2,824,878,0.28571
480,0,1,1,2,435,435,0.71429
480,25,0,0,3,496,471,0.14286
840,0,1,1,2,822,822,0.71429
840,0,1,1,3,851,851,0.85714
0,2,0,1,4,4,2,1
840,29,0,0,1,861,832,0.42857
240,-13,0,0,1,207,220,0.42857
240,-9,0,0,1,252,261,0.42857
480,0,1,0,1,471,471,0.42857
840,-48,0,0,1,819,867,0.42857
840,0,1,1,2,813,813,0.71429
480,0,1,1,3,468,468,0.85714
240,0,1,1,3,218,218,0.85714
0,-48,0,0,3,-33,15,0.14286
480,-35,0,0,3,474,509,0.14286
480,0,1,0,2,459,459,0.28571
0,0,1,1,2,-39,-39,0.71429
240,17,0,1,2,276,259,0.71429
480,0,1,1,1,490,490,0.57143
240,-10,0,1,3,222,232,0.85714
480,0,1,1,2,466,466,0.71429
840,0,1,0,1,867,867,0.42857
840,12,0,1,3,836,824,0.85714
840,0,1,1,3,859,859,0.85714
0,0,1,1,2,45,45,0.71429
0,0,1,1,3,-42,-42,0.85714
480,18,0,1,3,474,456,0.85714
0,-7,0,1,2,-19,-12,0.71429
840,-4,0,1,3,852,856,0.85714
240,-52,0,0,2,206,258,0.28571
240,0,1,1,3,230,230,0.85714
840,0,1,0,2,837,837,0.28571
480,0,1,1,2,482,482,0.71429
0,0,1,1,3,40,40,0.85714
480,0,1,1,4,441,441,1
480,0,1,1,4,517,517,1
240,2,0,1,3,250,248,0.85714
480,0,1,1,4,475,475,1
240,0,1,1,4,240,240,1
480,0,1,1,4,506,506,1
840,0,1,1,3,868,868,0.85714
240,0,1,1,3,238,238,0.85714
240,-18,0,1,2,236,254,0.71429
0,-37,0,0,1,-8,29,0.42857
840,0,1,0,2,862,862,0.28571
840,0,1,1,3,851,851,0.85714
240,-27,0,0,1,220,247,0.42857
840,0,1,1,4,805,805,1
840,0,1,0,1,855,855,0.42857
840,0,1,1,4,891,891,1
240,22,0,0,3,248,226,0.14286
0,-1,0,1,4,1,2,1
240,-15,0,0,1,243,258,0.42857
0,-48,0,0,2,-15,33,0.28571
0,0,1,1,4,-16,-16,1
480,27,0,0,2,536,509,0.28571
480,23,0,1,4,474,451,1
840,23,0,0,1,867,844,0.42857
0,0,1,1,4,-13,-13,1
240,0,1,1,4,206,206,1
480,49,0,0,3,530,481,0.14286
480,0,1,1,2,505,505,0.71429
0,52,0,0,2,40,-12,0.28571
840,0,1,0,1,853,853,0.42857
240,0,1,0,2,251,251,0.28571
240,0,1,1,3,249,249,0.85714
240,0,1,1,3,208,208,0.85714
0,-29,0,0,2,-32,-3,0.28571
840,23,0,1,2,843,820,0.71429
0,0,1,1,3,-12,-12,0.85714
240,-7,0,1,3,237,244,0.85714
0,52,0,0,3,11,-41,0.14286
0,0,1,1,2,-24,-24,0.71429
240,1,0,1,1,268,267,0.57143
480,0,1,0,2,464,464,0.28571
840,12,0,0,2,842,830,0.28571
0,54,0,0,3,53,-1,0.14286
240,0,1,0,2,251,251,0.28571
840,0,1,0,1,853,853,0.42857
0,-12,0,1,3,45,57,0.85714
240,0,1,1,2,241,241,0.71429
0,47,0,0,3,38,-9,0.14286
840,0,1,1,4,825,825,1
480,0,1,1,4,505,505,1
480,0,1,1,3,471,471,0.85714
840,0,1,0,2,836,836,0.28571
240,0,1,0,2,245,245,0.28571
840,-49,0,1,2,830,879,0.71429
840,0,1,0,2,822,822,0.28571
480,-38,0,1,3,479,517,0.85714
240,0,1,1,2,222,222,0.71429
0,0,1,1,3,-59,-59,0.85714
240,-31,0,0,2,219,250,0.28571
480,21,0,0,3,484,463,0.14286
0,0,1,1,3,46,46,0.85714
0,0,1,1,3,-4,-4,0.85714
480,0,1,1,3,475,475,0.85714
840,-33,0,0,2,813,846,0.28571
240,18,0,1,3,241,223,0.85714
840,16,0,1,4,821,805,1
0,-65,0,0,3,-42,23,0.14286
480,0,1,0,2,495,495,0.28571
840,-3,0,0,2,853,856,0.28571
840,0,1,1,2,854,854,0.71429
480,0,1,0,2,448,448,0.28571
0,-2,0,0,2,15,17,0.28571
240,0,1,0,2,245,245,0.28571
840,0,1,1,3,803,803,0.85714
840,0,1,1,4,812,812,1
0,18,0,0,2,2,-16,0.28571
240,0,1,1,4,210,210,1
840,-42,0,1,4,822,864,1
240,0,1,1,3,244,244,0.85714
0,0,1,1,2,-16,-16,0.71429
840,-19,0,0,3,825,844,0.14286
480,19,0,0,2,489,470,0.28571
480,11,0,1,2,484,473,0.71429
240,-11,0,1,3,230,241,0.85714
840,0,1,1,2,833,833,0.71429
480,0,1,1,2,485,485,0.71429
480,0,1,1,3,511,511,0.85714
480,-2,0,0,2,485,487,0.28571
480,0,1,0,2,445,445,0.28571
0,-17,0,0,2,2,19,0.28571
840,6,0,1,3,830,824,0.85714
840,-11,0,1,2,836,847,0.71429
480,4,0,0,2,499,495,0.28571
480,0,1,1,3,494,494,0.85714
0,10,0,0,2,1,-9,0.28571
240,0,1,1,2,243,243,0.71429
480,-30,0,0,2,439,469,0.28571
0,0,1,1,3,8,8,0.85714
840,29,0,0,3,876,847,0.14286
840,-10,0,0,2,834,844,0.28571
240,0,1,1,3,246,246,0.85714
480,29,0,0,2,480,451,0.28571
240,38,0,0,1,283,245,0.42857
0,-11,0,0,1,-21,-10,0.42857
840,-5,0,1,1,832,837,0.57143
240,0,1,1,3,269,269,0.85714
0,0,1,1,3,15,15,0.85714
240,27,0,0,2,267,240,0.28571
240,-30,0,0,1,188,218,0.42857
480,11,0,1,3,470,459,0.85714
240,0,1,1,3,234,234,0.85714
480,-23,0,0,2,497,520,0.28571
840,0,1,1,3,866,866,0.85714
480,0,1,1,2,468,468,0.71429
0,2,0,1,3,10,8,0.85714
840,0,1,1,3,833,833,0.85714
0,0,1,1,3,20,20,0.85714
480,0,1,0,1,466,466,0.42857
240,15,0,1,3,230,215,0.85714
240,8,0,1,3,201,193,0.85714
240,-3,0,1,3,253,256,0.85714
0,0,1,1,3,-18,-18,0.85714
240,0,1,0,1,246,246,0.42857
840,0,1,1,3,858,858,0.85714
0,0,1,1,3,-39,-39,0.85714
480,-57,0,0,1,433,490,0.42857
240,-7,0,1,3,259,266,0.85714
840,0,1,1,3,829,829,0.85714
240,22,0,1,3,242,220,0.85714
480,11,0,1,3,454,443,0.85714
480,-50,0,0,4,472,522,0
480,0,1,1,3,466,466,0.85714
0,30,0,0,4,9,-21,0
840,-6,0,1,4,857,863,1
0,0,1,1,4,-4,-4,1
240,10,0,1,4,239,229,1
840,0,1,0,2,819,819,0.28571
840,43,0,1,3,865,822,0.85714
840,0,1,1,3,859,859,0.85714
480,38,0,0,4,499,461,0
840,0,1,0,3,828,828,0.14286
240,0,1,1,3,244,244,0.85714
840,0,1,0,1,883,883,0.42857
840,0,1,1,3,827,827,0.85714
480,8,0,0,2,501,493,0.28571
240,0,1,1,3,269,269,0.85714
840,17,0,1,1,864,847,0.57143
0,0,1,1,3,13,13,0.85714
840,0,1,1,4,845,845,1
480,-4,0,0,1,493,497,0.42857
480,0,1,0,2,493,493,0.28571
0,-4,0,1,3,-10,-6,0.85714
240,0,1,1,2,247,247,0.71429
0,-14,0,0,1,-3,11,0.42857
240,-9,0,0,2,218,227,0.28571
840,0,1,1,3,867,867,0.85714
840,0,1,1,2,843,843,0.71429
840,0,1,0,1,833,833,0.42857
240,47,0,0,4,245,198,0
480,0,1,1,2,455,455,0.71429
0,-25,0,0,4,13,38,0
0,0,1,1,3,-20,-20,0.85714
480,-21,0,1,3,473,494,0.85714
480,0,1,0,4,495,495,0
480,59,0,0,4,546,487,0
240,0,1,1,2,225,225,0.71429
480,-37,0,0,4,452,489,0
480,0,1,0,4,470,470,0
0,-32,0,0,4,-38,-6,0
480,0,1,1,2,492,492,0.71429
240,-20,0,0,1,277,297,0.42857
240,0,1,1,3,268,268,0.85714
0,0,1,1,3,16,16,0.85714
240,-55,0,0,4,231,286,0
840,0,1,0,1,835,835,0.42857
840,-35,0,0,2,812,847,0.28571
840,0,1,1,2,847,847,0.71429
240,0,1,1,3,226,226,0.85714
240,-25,0,0,4,212,237,0
840,3,0,1,2,808,805,0.71429
240,0,1,1,3,217,217,0.85714
840,0,1,1,4,834,834,1
240,14,0,1,3,224,210,0.85714
240,9,0,0,4,253,244,0
0,14,0,1,3,3,-11,0.85714
480,0,1,0,3,461,461,0.14286
240,0,1,1,3,266,266,0.85714
840,0,1,1,3,811,811,0.85714
480,0,1,0,4,496,496,0
0,21,0,0,4,-2,-23,0
840,0,1,0,2,805,805,0.28571
480,0,1,1,3,461,461,0.85714
0,0,1,1,4,14,14,1
0,39,0,0,4,0,-39,0
480,0,1,1,2,514,514,0.71429
0,30,0,0,4,-14,-44,0
0,50,0,0,4,10,-40,0
0,0,1,0,4,34,34,0
240,0,1,1,4,228,228,1
840,50,0,0,4,866,816,0
840,16,0,0,3,861,845,0.14286
240,87,0,0,4,287,200,0
0,0,1,1,3,-19,-19,0.85714
0,30,0,0,4,46,16,0
480,5,0,0,4,487,482,0
840,0,1,0,3,843,843,0.14286
0,27,0,0,4,-9,-36,0
0,17,0,0,4,-4,-21,0
240,0,1,1,2,249,249,0.71429
480,0,1,1,3,532,532,0.85714
0,0,1,0,4,16,16,0
0,0,1,1,3,8,8,0.85714
480,12,0,0,4,470,458,0
480,0,1,1,3,491,491,0.85714
480,0,1,0,1,470,470,0.42857
480,-10,0,1,3,446,456,0.85714
840,-8,0,0,1,828,836,0.42857
0,-14,0,0,1,25,39,0.42857
0,16,0,1,3,-5,-21,0.85714
840,22,0,1,4,873,851,1
480,33,0,0,4,481,448,0
240,-12,0,0,2,250,262,0.28571
240,0,1,0,2,243,243,0.28571
0,0,1,1,4,0,0,1
480,0,1,0,4,476,476,0
240,0,1,1,4,214,214,1
0,0,1,1,4,5,5,1
840,0,1,0,1,818,818,0.42857
0,-67,0,0,4,-21,46,0
480,-18,0,0,1,456,474,0.42857
240,0,1,1,4,241,241,1
240,0,1,1,4,241,241,1
480,71,0,0,3,473,402,0.14286
840,0,1,0,4,828,828,0
480,-22,0,1,3,477,499,0.85714
0,-33,0,0,1,-23,10,0.42857
480,0,1,1,3,490,490,0.85714
0,-8,0,1,4,1,9,1
480,16,0,1,4,509,493,1
840,-7,0,0,1,806,813,0.42857
480,20,0,0,2,485,465,0.28571
840,4,0,0,3,926,922,0.14286
480,0,1,1,4,471,471,1
240,0,1,1,4,260,260,1
480,-39,0,1,3,427,466,0.85714
0,0,1,1,3,12,12,0.85714
840,-25,0,1,4,826,851,1
840,0,1,1,4,798,798,1
240,0,1,1,4,260,260,1
240,0,1,1,3,283,283,0.85714
0,18,0,0,1,-19,-37,0.42857
480,0,1,1,3,484,484,0.85714
0,0,1,1,3,10,10,0.85714
840,0,1,0,1,828,828,0.42857
840,0,1,1,3,851,851,0.85714
240,0,1,1,4,311,311,1
240,-50,0,0,4,217,267,0
0,0,1,1,3,-11,-11,0.85714
480,-20,0,0,1,455,475,0.42857
480,17,0,1,3,490,473,0.85714
0,22,0,0,1,15,-7,0.42857
480,0,1,1,3,493,493,0.85714
840,0,1,1,3,837,837,0.85714
840,0,1,1,3,821,821,0.85714
840,0,1,1,3,832,832,0.85714
0,-7,0,1,3,0,7,0.85714
840,0,1,0,1,806,806,0.42857
240,-45,0,0,4,226,271,0
840,0,1,1,4,807,807,1
840,-38,0,0,1,831,869,0.42857
480,-47,0,0,1,465,512,0.42857
0,0,1,1,4,0,0,1
0,0,1,1,4,4,4,1
240,0,1,1,4,230,230,1
240,-68,0,0,4,178,246,0
840,22,0,0,1,855,833,0.42857
0,0,1,1,4,-7,-7,1
480,0,1,1,4,482,482,1
840,0,1,0,1,805,805,0.42857
480,35,0,0,2,513,478,0.28571
480,0,1,1,4,466,466,1
0,0,1,1,4,33,33,1
840,16,0,0,1,834,818,0.42857
0,36,0,0,4,13,-23,0
840,0,1,0,1,822,822,0.42857
0,0,1,1,4,-4,-4,1
840,0,1,1,4,846,846,1
0,0,1,1,4,21,21,1
0,-31,0,0,4,15,46,0
840,-51,0,0,2,816,867,0.28571
480,0,1,0,3,515,515,0.14286
480,26,0,1,2,486,460,0.71429
240,-18,0,0,3,223,241,0.14286
480,0,1,1,4,492,492,1
0,1,0,1,4,29,28,1
840,0,1,1,4,835,835,1
240,19,0,0,3,261,242,0.14286
480,0,1,1,4,475,475,1
840,30,0,0,4,865,835,0
840,-23,0,1,3,839,862,0.85714
0,-10,0,0,1,-19,-9,0.42857
0,-89,0,0,4,-49,40,0
0,-7,0,0,1,-20,-13,0.42857
840,-51,0,1,4,782,833,1
840,0,1,0,1,850,850,0.42857
480,0,1,1,3,482,482,0.85714
240,32,0,1,3,261,229,0.85714
480,0,1,1,3,452,452,0.85714
0,0,1,0,1,-11,-11,0.42857
240,10,0,0,1,233,223,0.42857
480,0,1,1,3,514,514,0.85714
480,0,1,1,4,468,468,1
0,-34,0,0,4,4,38,0
840,3,0,1,4,865,862,1
0,0,1,1,4,-31,-31,1
840,28,0,1,4,845,817,1
0,0,1,1,4,-35,-35,1
240,0,1,1,4,229,229,1
240,-17,0,0,2,246,263,0.28571
840,0,1,0,2,859,859,0.28571
240,0,1,1,3,224,224,0.85714
480,0,1,1,2,494,494,0.71429
840,1,0,0,1,823,822,0.42857
0,41,0,0,4,13,-28,0
240,-68,0,0,4,223,291,0
0,0,1,1,3,-27,-27,0.85714
0,0,1,1,4,22,22,1
840,19,0,0,1,884,865,0.42857
840,19,0,0,1,891,872,0.42857
0,0,1,1,4,9,9,1
240,-31,0,0,1,217,248,0.42857
480,64,0,0,4,500,436,0
480,0,1,0,4,477,477,0
240,26,0,0,1,260,234,0.42857
240,-27,0,0,4,235,262,0
840,-27,0,0,1,838,865,0.42857
480,22,0,0,4,452,430,0
0,-24,0,0,1,-46,-22,0.42857
0,0,1,1,4,-30,-30,1
480,37,0,0,3,497,460,0.14286
840,0,1,0,4,844,844,0
240,-7,0,1,1,214,221,0.57143
480,-13,0,0,1,473,486,0.42857
240,42,0,0,3,274,232,0.14286
840,0,1,0,3,852,852,0.14286
240,0,1,1,3,242,242,0.85714
480,11,0,0,1,546,535,0.42857
480,0,1,0,2,516,516,0.28571
0,-2,0,1,3,-12,-10,0.85714
0,0,1,1,3,8,8,0.85714
840,0,1,0,1,872,872,0.42857
0,24,0,0,3,42,18,0.14286
0,0,1,1,3,-8,-8,0.85714
840,0,1,0,1,856,856,0.42857
480,-63,0,0,3,457,520,0.14286
480,0,1,1,3,455,455,0.85714
240,-4,0,1,3,241,245,0.85714
240,64,0,0,4,251,187,0
240,-66,0,0,4,205,271,0
240,0,1,0,2,248,248,0.28571
480,0,1,1,3,467,467,0.85714
480,0,1,0,1,490,490,0.42857
240,0,1,1,3,270,270,0.85714
840,26,0,1,4,852,826,1
240,0,1,1,4,221,221,1
840,0,1,0,1,811,811,0.42857
480,22,0,0,2,490,468,0.28571
240,10,0,0,2,252,242,0.28571
840,-5,0,1,3,888,893,0.85714
480,12,0,1,4,465,453,1
0,13,0,0,1,19,6,0.42857
840,33,0,0,1,839,806,0.42857
480,0,1,1,4,504,504,1
840,-1,0,1,4,839,840,1
480,-19,0,1,4,438,457,1
0,-42,0,0,4,-30,12,0
240,0,1,1,4,223,223,1
840,-12,0,0,1,844,856,0.42857
240,16,0,0,1,244,228,0.42857
240,0,1,1,4,259,259,1
240,0,1,1,4,251,251,1
240,0,1,1,4,231,231,1
840,0,1,1,4,814,814,1
840,16,0,1,4,801,785,1
480,-2,0,1,4,473,475,1
480,-7,0,1,4,454,461,1
240,0,1,1,4,217,217,1
840,0,1,0,1,838,838,0.42857
240,-8,0,1,3,247,255,0.85714
480,0,1,0,4,511,511,0
0,0,1,1,4,7,7,1
0,0,1,1,4,-10,-10,1
480,0,1,0,2,521,521,0.28571
240,53,0,0,4,274,221,0
840,0,1,1,4,836,836,1
480,0,1,0,1,479,479,0.42857
240,0,1,1,4,263,263,1
0,10,0,1,4,19,9,1
480,0,1,0,1,499,499,0.42857
480,-41,0,1,4,452,493,1
0,0,1,1,4,30,30,1
240,0,1,1,4,230,230,1
0,0,1,1,4,-36,-36,1
480,-84,0,0,4,433,517,0
840,0,1,1,4,819,819,1
480,45,0,0,4,481,436,0
480,-37,0,1,4,437,474,1
480,0,1,0,2,499,499,0.28571
840,0,1,1,4,831,831,1
840,0,1,1,4,814,814,1
240,-53,0,0,4,216,269,0
480,0,1,0,2,482,482,0.28571
480,0,1,1,4,472,472,1
480,6,0,0,1,498,492,0.42857
840,28,0,1,4,853,825,1
480,-27,0,0,1,466,493,0.42857
0,0,1,1,4,14,14,1
240,-20,0,0,1,247,267,0.42857
240,-7,0,1,4,233,240,1
480,1,0,0,1,490,489,0.42857
240,0,1,1,4,253,253,1
0,14,0,0,4,28,14,0
240,0,1,1,4,239,239,1
0,0,1,1,4,63,63,1
240,0,1,1,4,306,306,1
240,0,1,1,4,232,232,1
480,0,1,0,1,488,488,0.42857
840,0,1,0,1,849,849,0.42857
0,0,1,1,4,3,3,1
240,0,1,1,4,222,222,1
480,0,1,0,1,466,466,0.42857
480,56,0,0,4,512,456,0
840,-18,0,1,4,808,826,1
240,0,1,1,4,208,208,1
480,0,1,1,4,480,480,1
480,0,1,1,4,481,481,1
0,0,1,1,4,-31,-31,1
0,0,1,1,4,39,39,1
0,-10,0,0,4,29,39,0
0,0,1,1,4,-34,-34,1
240,0,1,1,4,255,255,1
240,-6,0,1,4,223,229,1
480,0,1,1,4,484,484,1
480,0,1,1,4,516,516,1
0,22,0,0,2,4,-18,0.28571
840,55,0,0,3,887,832,0.14286
240,9,0,1,4,235,226,1
0,-37,0,0,4,-21,16,0
240,0,1,1,4,231,231,1
480,-11,0,1,3,450,461,0.85714
480,0,1,1,2,458,458,0.71429
240,0,1,1,4,242,242,1
240,0,1,1,4,202,202,1
240,0,1,1,3,246,246,0.85714
240,-4,0,1,3,261,265,0.85714
0,0,1,1,4,12,12,1
480,0,1,0,1,480,480,0.42857
840,0,1,1,3,874,874,0.85714
0,0,1,1,4,3,3,1
0,-26,0,0,1,-18,8,0.42857
480,-44,0,0,3,452,496,0.14286
840,20,0,0,4,882,862,0
840,0,1,0,4,835,835,0
840,0,1,0,3,843,843,0.14286
840,-11,0,0,2,832,843,0.28571
480,36,0,1,3,525,489,0.85714
480,-67,0,0,4,447,514,0
240,0,1,0,3,267,267,0.14286
240,0,1,0,1,260,260,0.42857
840,0,1,1,3,840,840,0.85714
0,0,1,1,3,-17,-17,0.85714
0,0,1,1,4,-6,-6,1
840,0,1,0,1,851,851,0.42857
240,22,0,0,1,250,228,0.42857
840,17,0,0,2,865,848,0.28571
240,-5,0,1,3,228,233,0.85714
0,16,0,1,4,-23,-39,1
840,0,1,1,3,882,882,0.85714
480,48,0,0,4,497,449,0
0,0,1,1,3,16,16,0.85714
840,0,1,1,4,854,854,1
0,0,1,1,4,-19,-19,1
480,0,1,0,2,441,441,0.28571
240,0,1,1,3,184,184,0.85714
0,0,1,1,3,57,57,0.85714
840,0,1,0,1,803,803,0.42857
0,3,0,1,4,-4,-7,1
240,-17,0,0,1,191,208,0.42857
0,-25,0,0,1,-21,4,0.42857
0,36,0,0,4,17,-19,0
0,-15,0,0,1,-24,-9,0.42857
0,-11,0,1,4,-30,-19,1
240,9,0,1,4,222,213,1
240,0,1,0,1,290,290,0.42857
480,14,0,0,1,529,515,0.42857
0,-37,0,0,4,-14,23,0
240,23,0,0,4,242,219,0
0,22,0,0,4,-9,-31,0
240,0,1,1,4,232,232,1
480,2,0,0,1,470,468,0.42857
840,0,1,0,1,832,832,0.42857
0,0,1,1,4,-16,-16,1
240,0,1,0,1,236,236,0.42857
480,69,0,0,4,537,468,0
240,0,1,1,4,231,231,1
480,0,1,0,1,502,502,0.42857
840,35,0,0,4,834,799,0
840,12,0,0,4,873,861,0
240,4,0,0,1,238,234,0.42857
0,14,0,1,3,48,34,0.85714
840,18,0,0,1,851,833,0.42857
240,0,1,0,1,214,214,0.42857
0,0,1,1,3,55,55,0.85714
240,56,0,0,4,244,188,0
240,0,1,0,1,278,278,0.42857
0,17,0,0,1,15,-2,0.42857
240,-30,0,0,1,239,269,0.42857
480,0,1,1,3,479,479,0.85714
840,51,0,0,4,884,833,0
240,-9,0,0,1,224,233,0.42857
0,-3,0,1,3,-14,-11,0.85714
480,1,0,1,4,475,474,1
0,0,1,1,2,-23,-23,0.71429
240,0,1,1,4,225,225,1
840,21,0,1,4,863,842,1
840,-21,0,0,3,845,866,0.14286
480,0,1,0,3,456,456,0.14286
0,68,0,0,4,20,-48,0
240,-14,0,0,1,223,237,0.42857
240,0,1,1,4,251,251,1
840,0,1,0,1,817,817,0.42857
480,-1,0,1,3,511,512,0.85714
840,-10,0,1,4,840,850,1
240,13,0,0,1,219,206,0.42857
0,0,1,1,4,12,12,1
840,0,1,1,4,841,841,1
0,0,1,1,4,-44,-44,1
240,52,0,0,4,259,207,0
0,0,1,1,4,-13,-13,1
840,-5,0,1,4,830,835,1
0,51,0,0,1,28,-23,0.42857
0,0,1,1,4,-26,-26,1
840,18,0,0,1,862,844,0.42857
480,9,0,0,2,484,475,0.28571
0,47,0,0,4,48,1,0
480,9,0,0,1,478,469,0.42857
240,-15,0,1,4,218,233,1
480,0,1,1,4,458,458,1
0,15,0,1,4,13,-2,1
840,39,0,0,1,840,801,0.42857
0,17,0,0,4,-29,-46,0
0,-14,0,1,4,1,15,1
0,0,1,1,4,64,64,1
0,0,1,1,4,-14,-14,1
240,0,1,1,4,259,259,1
480,0,1,0,1,490,490,0.42857
840,0,1,1,4,869,869,1
0,-10,0,1,4,1,11,1
840,-2,0,0,4,853,855,0
840,-57,0,0,4,815,872,0
0,2,0,1,4,12,10,1
0,-22,0,0,4,-16,6,0
240,-12,0,0,2,238,250,0.28571
240,-5,0,0,2,226,231,0.28571
480,0,1,1,4,457,457,1
480,3,0,1,3,468,465,0.85714
240,0,1,1,3,252,252,0.85714
480,0,1,1,3,451,451,0.85714
480,-32,0,0,1,479,511,0.42857
240,14,0,1,4,239,225,1
480,0,1,1,4,485,485,1
240,0,1,1,4,226,226,1
840,7,0,0,1,818,811,0.42857
240,35,0,0,4,291,256,0
0,0,1,1,4,38,38,1
480,0,1,1,4,511,511,1
0,0,1,0,1,20,20,0.42857
480,0,1,1,4,490,490,1
240,0,1,1,4,260,260,1
0,-16,0,0,3,-20,-4,0.14286
480,0,1,1,4,473,473,1
480,-51,0,0,1,487,538,0.42857
240,0,1,1,4,257,257,1
480,-22,0,0,1,489,511,0.42857
480,0,1,1,4,470,470,1
840,-56,0,0,3,780,836,0.14286
0,0,1,1,4,44,44,1
840,93,0,0,4,901,808,0
0,0,1,0,1,20,20,0.42857
840,-24,0,1,3,832,856,0.85714
840,0,1,0,3,860,860,0.14286
480,-6,0,1,4,468,474,1
240,0,1,0,1,218,218,0.42857
840,0,1,1,3,766,766,0.85714
240,-16,0,0,1,234,250,0.42857
240,12,0,1,3,262,250,0.85714
480,-11,0,0,2,460,471,0.28571
0,19,0,1,4,11,-8,1
840,0,1,0,1,832,832,0.42857
840,-59,0,0,1,827,886,0.42857
240,0,1,1,3,233,233,0.85714
480,36,0,0,1,502,466,0.42857
840,0,1,0,2,818,818,0.28571
0,-28,0,0,1,-18,10,0.42857
840,-30,0,0,1,855,885,0.42857
240,0,1,1,3,248,248,0.85714
480,-2,0,1,2,477,479,0.71429
840,38,0,0,1,858,820,0.42857
480,44,0,0,3,508,464,0.14286
840,0,1,0,1,803,803,0.42857
840,-49,0,1,4,804,853,1
480,3,0,0,3,484,481,0.14286
0,88,0,0,3,85,-3,0.14286
240,0,1,0,3,186,186,0.14286
840,31,0,0,4,853,822,0
240,0,1,0,3,258,258,0.14286
480,-17,0,0,3,486,503,0.14286
840,-27,0,1,3,823,850,0.85714
840,27,0,0,4,848,821,0
240,0,1,1,3,268,268,0.85714
240,-37,0,0,4,194,231,0
840,-50,0,0,2,809,859,0.28571
240,0,1,1,3,231,231,0.85714
240,0,1,1,4,225,225,1
0,-6,0,1,4,12,18,1
840,-2,0,0,1,857,859,0.42857
0,13,0,1,4,7,-6,1
0,-43,0,0,4,-18,25,0
480,-26,0,0,4,483,509,0
480,0,1,0,2,484,484,0.28571
840,0,1,0,2,841,841,0.28571
480,-37,0,0,2,446,483,0.28571
840,0,1,0,3,838,838,0.14286
840,0,1,0,2,863,863,0.28571
840,-32,0,0,3,803,835,0.14286
480,-51,0,0,4,434,485,0
840,0,1,0,2,846,846,0.28571
240,50,0,0,4,303,253,0
240,0,1,1,2,278,278,0.71429
240,30,0,0,4,255,225,0
840,0,1,0,4,832,832,0
240,0,1,1,3,235,235,0.85714
480,0,1,1,4,497,497,1
0,-2,0,1,4,2,4,1
240,0,1,1,4,253,253,1
480,20,0,1,4,505,485,1
0,0,1,1,4,17,17,1
840,30,0,0,2,872,842,0.28571
840,0,1,1,4,826,826,1
0,-14,0,1,4,-33,-19,1
0,-36,0,0,4,-42,-6,0
0,0,1,0,4,3,3,0
240,24,0,0,2,277,253,0.28571
0,0,1,1,4,4,4,1
840,0,1,1,3,865,865,0.85714
240,0,1,1,4,251,251,1
840,0,1,1,4,907,907,1
0,-25,0,0,3,-7,18,0.14286
840,-44,0,0,3,806,850,0.14286
480,-9,0,0,1,454,463,0.42857
240,0,1,1,3,216,216,0.85714
240,0,1,1,4,236,236,1
240,0,1,1,4,204,204,1
0,0,1,1,4,-4,-4,1
240,37,0,0,4,238,201,0
840,0,1,0,4,837,837,0
840,-26,0,0,3,805,831,0.14286
0,0,1,1,4,-33,-33,1
0,26,0,0,4,40,14,0
0,0,1,1,4,10,10,1
840,0,1,0,1,801,801,0.42857
0,0,1,1,4,-7,-7,1
0,0,1,1,4,-28,-28,1
840,0,1,0,2,813,813,0.28571
480,0,1,1,4,497,497,1
0,0,1,1,4,-53,-53,1
840,-51,0,0,3,808,859,0.14286
840,-13,0,0,3,842,855,0.14286
