240,-1,0,1,1,267,268,0.57143
0,0,1,1,1,9,9,0.57143
840,0,1,0,1,882,882,0.42857
480,37,0,0,2,501,464,0.28571
240,-23,0,0,2,220,243,0.28571
240,-16,0,0,1,232,248,0.42857
480,49,0,0,1,519,470,0.42857
480,0,1,0,1,524,524,0.42857
840,0,1,1,1,851,851,0.57143
240,6,0,1,1,279,273,0.57143
840,0,1,0,2,794,794,0.28571
480,-19,0,0,1,501,520,0.42857
840,0,1,0,1,824,824,0.42857
840,12,0,1,1,837,825,0.57143
840,12,0,1,1,869,857,0.57143
240,-50,0,0,3,193,243,0.14286
840,-10,0,0,1,833,843,0.42857
840,-19,0,0,1,826,845,0.42857
240,-51,0,0,3,243,294,0.14286
480,0,1,1,1,485,485,0.57143
240,0,1,1,1,258,258,0.57143
0,0,1,1,1,-18,-18,0.57143
480,0,1,0,1,452,452,0.42857
840,0,1,0,2,893,893,0.28571
480,0,1,0,2,480,480,0.28571
0,35,0,0,3,10,-25,0.14286
0,60,0,0,4,45,-15,0
0,15,0,0,3,41,26,0.14286
240,-41,0,0,3,213,254,0.14286
240,0,1,1,2,246,246,0.71429
240,0,1,1,1,183,183,0.57143
0,0,1,1,3,-55,-55,0.85714
0,0,1,1,3,-32,-32,0.85714
0,0,1,1,3,-60,-60,0.85714
480,67,0,0,3,479,412,0.14286
480,18,0,0,2,498,480,0.28571
0,-69,0,0,3,-9,60,0.14286
240,0,1,1,3,195,195,0.85714
480,0,1,1,2,448,448,0.71429
840,27,0,1,1,826,799,0.57143
840,-18,0,1,1,824,842,0.57143
240,0,1,1,2,255,255,0.71429
480,0,1,1,2,500,500,0.71429
480,-15,0,0,2,478,493,0.28571
840,0,1,1,2,830,830,0.71429
240,0,1,1,1,245,245,0.57143
840,-50,0,0,1,797,847,0.42857
840,8,0,1,1,857,849,0.57143
0,62,0,1,3,31,-31,0.85714
240,0,1,1,2,237,237,0.71429
840,7,0,1,2,852,845,0.71429
0,68,0,0,3,25,-43,0.14286
840,-35,0,1,2,835,870,0.71429
0,4,0,1,2,16,12,0.71429
840,0,1,1,2,833,833,0.71429
840,38,0,1,2,856,818,0.71429
0,0,1,1,3,6,6,0.85714
480,-16,0,1,3,445,461,0.85714
0,0,1,1,3,22,22,0.85714
0,-16,0,0,2,6,22,0.28571
840,0,1,0,2,831,831,0.28571
240,0,1,1,3,200,200,0.85714
0,-7,0,0,1,3,10,0.42857
840,38,0,1,2,884,846,0.71429
840,-22,0,1,1,826,848,0.57143
240,6,0,1,1,256,250,0.57143
480,0,1,1,1,502,502,0.57143
840,0,1,1,1,814,814,0.57143
840,0,1,1,1,877,877,0.57143
840,0,1,1,1,820,820,0.57143
480,54,0,0,2,518,464,0.28571
480,0,1,1,1,479,479,0.57143
0,0,1,1,3,11,11,0.85714
240,0,1,1,3,237,237,0.85714
240,0,1,1,3,254,254,0.85714
840,41,0,0,2,876,835,0.28571
240,-18,0,1,1,220,238,0.57143
840,0,1,0,2,854,854,0.28571
0,48,0,0,3,12,-36,0.14286
840,0,1,1,1,796,796,0.57143
240,-10,0,1,2,242,252,0.71429
240,-32,0,0,2,206,238,0.28571
240,0,1,1,2,240,240,0.71429
480,0,1,0,2,470,470,0.28571
480,0,1,1,2,482,482,0.71429
480,0,1,1,2,444,444,0.71429
480,0,1,1,2,485,485,0.71429
0,-17,0,0,1,-18,-1,0.42857
240,39,0,0,1,236,197,0.42857
0,0,1,1,3,-9,-9,0.85714
480,0,1,1,1,473,473,0.57143
0,-5,0,1,1,-2,3,0.57143
840,-44,0,0,1,834,878,0.42857
240,0,1,1,1,251,251,0.57143
480,0,1,0,1,471,471,0.42857
840,0,1,1,1,842,842,0.57143
0,0,1,1,1,3,3,0.57143
480,-58,0,0,2,471,529,0.28571
240,-28,0,0,2,225,253,0.28571
240,6,0,1,1,257,251,0.57143
240,0,1,1,1,247,247,0.57143
480,0,1,1,1,491,491,0.57143
0,0,1,1,1,24,24,0.57143
0,-41,0,0,3,-20,21,0.14286
480,14,0,0,2,480,466,0.28571
480,0,1,0,2,493,493,0.28571
480,-32,0,1,2,468,500,0.71429
0,0,1,1,3,15,15,0.85714
840,0,1,1,2,855,855,0.71429
840,0,1,1,1,838,838,0.57143
240,-12,0,1,1,230,242,0.57143
0,8,0,0,2,38,30,0.28571
0,0,1,1,2,46,46,0.71429
840,14,0,0,3,816,802,0.14286
480,0,1,0,2,472,472,0.28571
0,0,1,1,1,30,30,0.57143
0,0,1,1,3,-25,-25,0.85714
0,-18,0,0,2,-24,-6,0.28571
240,0,1,1,3,233,233,0.85714
240,0,1,1,3,231,231,0.85714
840,0,1,1,1,822,822,0.57143
240,-29,0,0,2,232,261,0.28571
240,0,1,0,1,237,237,0.42857
480,-12,0,1,1,467,479,0.57143
480,0,1,0,2,499,499,0.28571
480,0,1,1,1,500,500,0.57143
240,0,1,0,1,260,260,0.42857
240,0,1,0,1,224,224,0.42857
480,0,1,1,2,490,490,0.71429
480,0,1,1,2,455,455,0.71429
240,57,0,0,3,266,209,0.14286
0,-4,0,1,2,-11,-7,0.71429
240,0,1,1,3,237,237,0.85714
0,0,1,1,3,-13,-13,0.85714
240,48,0,0,3,255,207,0.14286
480,16,0,0,2,485,469,0.28571
240,-81,0,0,3,173,254,0.14286
840,0,1,1,1,822,822,0.57143
240,0,1,1,1,230,230,0.57143
840,0,1,0,2,857,857,0.28571
240,0,1,0,2,245,245,0.28571
240,0,1,1,3,211,211,0.85714
840,0,1,0,1,856,856,0.42857
240,0,1,0,1,226,226,0.42857
0,0,1,1,3,-15,-15,0.85714
480,0,1,1,2,507,507,0.71429
0,12,0,0,2,2,-10,0.28571
240,71,0,0,3,283,212,0.14286
0,-15,0,1,1,-26,-11,0.57143
240,0,1,0,1,246,246,0.42857
240,-47,0,0,3,231,278,0.14286
480,-15,0,1,1,480,495,0.57143
480,0,1,0,1,490,490,0.42857
480,10,0,1,1,463,453,0.57143
480,-61,0,0,2,464,525,0.28571
240,-33,0,0,2,207,240,0.28571
0,-27,0,0,2,2,29,0.28571
480,0,1,1,1,501,501,0.57143
240,0,1,1,2,250,250,0.71429
240,65,0,0,3,263,198,0.14286
0,16,0,0,2,2,-14,0.28571
840,0,1,1,1,883,883,0.57143
840,-49,0,0,2,841,890,0.28571
840,0,1,1,2,793,793,0.71429
840,0,1,1,2,835,835,0.71429
840,-66,0,0,2,816,882,0.28571
840,0,1,1,1,844,844,0.57143
840,-49,0,1,1,832,881,0.57143
480,-37,0,0,1,479,516,0.42857
480,44,0,0,2,530,486,0.28571
240,0,1,1,1,187,187,0.57143
0,0,1,1,3,-5,-5,0.85714
840,0,1,0,1,798,798,0.42857
240,0,1,1,2,235,235,0.71429
480,-27,0,1,2,509,536,0.71429
840,0,1,1,1,832,832,0.57143
840,0,1,1,2,836,836,0.71429
240,-30,0,0,2,234,264,0.28571
240,-52,0,0,2,199,251,0.28571
240,44,0,1,3,263,219,0.85714
840,-25,0,0,2,845,870,0.28571
240,-48,0,0,3,200,248,0.14286
240,0,1,1,2,220,220,0.71429
240,0,1,1,3,255,255,0.85714
0,7,0,1,1,13,6,0.57143
0,55,0,0,3,47,-8,0.14286
240,-69,0,0,3,217,286,0.14286
480,7,0,0,1,468,461,0.42857
840,15,0,1,1,839,824,0.57143
240,33,0,0,3,249,216,0.14286
480,0,1,1,1,504,504,0.57143
480,30,0,1,1,472,442,0.57143
240,34,0,0,3,254,220,0.14286
840,0,1,1,1,832,832,0.57143
840,-15,0,1,2,856,871,0.71429
480,0,1,1,2,459,459,0.71429
240,0,1,1,2,188,188,0.71429
840,35,0,1,1,826,791,0.57143
840,0,1,1,1,841,841,0.57143
240,8,0,1,2,244,236,0.71429
480,29,0,1,2,511,482,0.71429
0,0,1,1,3,-9,-9,0.85714
0,17,0,0,2,10,-7,0.28571
0,58,0,0,4,40,-18,0
840,-50,0,1,1,808,858,0.57143
840,0,1,1,1,845,845,0.57143
240,-18,0,0,1,205,223,0.42857
240,0,1,0,1,215,215,0.42857
840,-12,0,1,1,824,836,0.57143
240,0,1,1,1,240,240,0.57143
480,-2,0,1,2,473,475,0.71429
840,0,1,1,2,834,834,0.71429
840,10,0,1,1,853,843,0.57143
240,0,1,1,2,228,228,0.71429
840,23,0,1,2,864,841,0.71429
240,1,0,1,2,242,241,0.71429
0,52,0,0,3,18,-34,0.14286
480,0,1,1,2,448,448,0.71429
480,0,1,1,2,431,431,0.71429
480,0,1,1,2,477,477,0.71429
480,-59,0,0,2,442,501,0.28571
240,-22,0,0,2,241,263,0.28571
840,0,1,0,1,874,874,0.42857
240,55,0,0,3,255,200,0.14286
0,0,1,1,3,-3,-3,0.85714
480,0,1,1,3,516,516,0.85714
0,0,1,1,4,6,6,1
840,5,0,1,1,830,825,0.57143
0,-23,0,0,2,-29,-6,0.28571
0,0,1,1,2,-15,-15,0.71429
480,0,1,1,1,459,459,0.57143
0,0,1,1,2,22,22,0.71429
0,45,0,0,3,20,-25,0.14286
480,0,1,1,1,489,489,0.57143
0,-25,0,0,2,-9,16,0.28571
840,0,1,1,1,812,812,0.57143
240,0,1,1,1,227,227,0.57143
480,-18,0,1,1,472,490,0.57143
840,0,1,1,2,838,838,0.71429
840,19,0,0,1,850,831,0.42857
240,7,0,0,1,244,237,0.42857
480,-31,0,1,1,439,470,0.57143
240,25,0,0,2,235,210,0.28571
240,0,1,1,1,223,223,0.57143
240,13,0,0,2,251,238,0.28571
480,0,1,0,2,458,458,0.28571
0,18,0,0,3,14,-4,0.14286
240,8,0,1,1,285,277,0.57143
240,0,1,0,1,267,267,0.42857
840,0,1,0,1,818,818,0.42857
240,23,0,0,1,232,209,0.42857
240,-26,0,0,2,206,232,0.28571
840,-23,0,0,1,844,867,0.42857
0,0,1,1,3,10,10,0.85714
240,0,1,1,1,230,230,0.57143
480,6,0,0,1,455,449,0.42857
0,-1,0,1,3,17,18,0.85714
240,-41,0,0,3,192,233,0.14286
240,17,0,0,2,269,252,0.28571
480,47,0,0,2,512,465,0.28571
0,33,0,0,3,6,-27,0.14286
240,0,1,1,3,238,238,0.85714
0,12,0,1,1,24,12,0.57143
480,56,0,0,2,496,440,0.28571
240,65,0,0,3,262,197,0.14286
480,0,1,0,1,491,491,0.42857
840,-36,0,0,1,830,866,0.42857
840,-11,0,1,1,833,844,0.57143
240,0,1,1,2,265,265,0.71429
480,0,1,1,2,489,489,0.71429
0,0,1,1,2,13,13,0.71429
0,0,1,1,3,-11,-11,0.85714
0,0,1,1,3,-47,-47,0.85714
0,38,0,0,3,37,-1,0.14286
840,0,1,1,1,872,872,0.57143
240,-52,0,0,3,228,280,0.14286
480,0,1,1,2,502,502,0.71429
0,0,1,1,3,-41,-41,0.85714
840,0,1,1,1,834,834,0.57143
840,0,1,1,1,840,840,0.57143
480,0,1,1,1,462,462,0.57143
240,0,1,1,1,239,239,0.57143
240,-70,0,0,3,209,279,0.14286
840,0,1,0,2,844,844,0.28571
480,-41,0,0,2,463,504,0.28571
480,0,1,1,2,458,458,0.71429
840,24,0,1,1,837,813,0.57143
240,9,0,1,1,261,252,0.57143
240,0,1,1,1,201,201,0.57143
840,0,1,1,1,827,827,0.57143
840,0,1,1,1,838,838,0.57143
240,0,1,1,1,266,266,0.57143
480,0,1,1,2,471,471,0.71429
240,0,1,0,2,222,222,0.28571
840,51,0,0,2,878,827,0.28571
0,0,1,1,2,-26,-26,0.71429
0,0,1,1,3,-30,-30,0.85714
480,0,1,1,3,498,498,0.85714
480,0,1,1,1,473,473,0.57143
240,0,1,0,1,225,225,0.42857
0,-44,0,0,3,-17,27,0.14286
240,5,0,1,2,233,228,0.71429
840,0,1,0,2,832,832,0.28571
480,0,1,0,2,476,476,0.28571
0,0,1,1,3,9,9,0.85714
240,-7,0,0,1,225,232,0.42857
240,0,1,1,2,266,266,0.71429
480,1,0,1,2,472,471,0.71429
0,-9,0,0,1,-26,-17,0.42857
840,-23,0,1,2,833,856,0.71429
0,0,1,1,2,-21,-21,0.71429
480,18,0,1,1,503,485,0.57143
0,0,1,1,2,-15,-15,0.71429
0,0,1,1,2,62,62,0.71429
480,-9,0,1,2,457,466,0.71429
840,0,1,1,2,822,822,0.71429
480,0,1,1,2,511,511,0.71429
840,48,0,0,2,873,825,0.28571
0,4,0,1,2,8,4,0.71429
480,25,0,1,2,472,447,0.71429
0,-40,0,0,3,6,46,0.14286
0,-41,0,0,3,-7,34,0.14286
480,0,1,1,1,466,466,0.57143
480,-7,0,1,1,504,511,0.57143
0,60,0,0,3,41,-19,0.14286
840,27,0,0,2,866,839,0.28571
0,0,1,1,1,3,3,0.57143
0,0,1,1,2,27,27,0.71429
480,-14,0,0,2,483,497,0.28571
480,0,1,1,3,446,446,0.85714
240,-23,0,0,2,219,242,0.28571
0,-16,0,0,2,5,21,0.28571
0,-59,0,0,3,-13,46,0.14286
240,35,0,0,3,269,234,0.14286
480,0,1,1,1,494,494,0.57143
840,0,1,1,1,854,854,0.57143
480,0,1,1,2,487,487,0.71429
240,0,1,1,2,248,248,0.71429
840,0,1,1,2,849,849,0.71429
480,0,1,1,2,491,491,0.71429
480,6,0,0,1,478,472,0.42857
0,0,1,1,3,22,22,0.85714
0,0,1,1,3,9,9,0.85714
480,0,1,1,1,470,470,0.57143
480,-58,0,0,2,479,537,0.28571
0,0,1,1,2,27,27,0.71429
840,0,1,1,2,865,865,0.71429
840,0,1,1,2,852,852,0.71429
840,8,0,1,1,854,846,0.57143
840,27,0,1,1,826,799,0.57143
240,0,1,1,1,265,265,0.57143
240,0,1,1,1,239,239,0.57143
840,0,1,1,1,862,862,0.57143
840,-23,0,0,1,845,868,0.42857
840,-5,0,1,1,822,827,0.57143
840,0,1,1,1,895,895,0.57143
840,0,1,0,1,851,851,0.42857
240,0,1,1,2,285,285,0.71429
240,-74,0,0,3,187,261,0.14286
0,9,0,0,2,6,-3,0.28571
0,-20,0,0,2,4,24,0.28571
840,35,0,0,2,857,822,0.28571
240,0,1,0,2,279,279,0.28571
240,17,0,0,2,209,192,0.28571
480,0,1,1,2,476,476,0.71429
480,0,1,1,1,466,466,0.57143
480,0,1,1,2,467,467,0.71429
840,0,1,1,2,826,826,0.71429
0,38,0,0,3,45,7,0.14286
240,10,0,0,2,232,222,0.28571
0,0,1,1,1,-42,-42,0.57143
840,2,0,1,1,848,846,0.57143
840,12,0,0,1,839,827,0.42857
480,-28,0,0,2,488,516,0.28571
0,0,1,1,2,-50,-50,0.71429
480,0,1,1,3,485,485,0.85714
840,-59,0,0,1,827,886,0.42857
240,0,1,1,1,221,221,0.57143
0,-24,0,0,2,-31,-7,0.28571
840,0,1,0,2,834,834,0.28571
480,0,1,1,2,489,489,0.71429
240,13,0,0,1,220,207,0.42857
0,-28,0,0,3,-35,-7,0.14286
0,-14,0,0,2,-27,-13,0.28571
840,-12,0,1,1,833,845,0.57143
480,0,1,1,1,487,487,0.57143
240,-3,0,0,1,232,235,0.42857
480,0,1,1,1,490,490,0.57143
0,0,1,1,3,16,16,0.85714
840,0,1,0,1,823,823,0.42857
480,0,1,0,1,479,479,0.42857
0,0,1,1,2,19,19,0.71429
0,0,1,1,2,41,41,0.71429
480,0,1,0,2,441,441,0.28571
240,5,0,1,2,258,253,0.71429
0,0,1,1,2,5,5,0.71429
240,0,1,0,1,266,266,0.42857
840,1,0,1,1,854,853,0.57143
0,-25,0,0,2,-26,-1,0.28571
240,-15,0,1,2,212,227,0.71429
0,0,1,1,2,-14,-14,0.71429
240,-44,0,0,2,240,284,0.28571
480,-10,0,1,2,487,497,0.71429
240,-52,0,0,3,194,246,0.14286
480,0,1,1,1,448,448,0.57143
480,34,0,0,2,486,452,0.28571
0,0,1,0,1,-38,-38,0.42857
840,0,1,1,1,839,839,0.57143
240,-15,0,1,2,223,238,0.71429
240,0,1,1,3,242,242,0.85714
480,0,1,1,2,459,459,0.71429
840,22,0,1,1,831,809,0.57143
480,36,0,0,2,505,469,0.28571
480,3,0,1,1,496,493,0.57143
240,0,1,1,1,258,258,0.57143
480,10,0,1,1,471,461,0.57143
840,0,1,1,1,850,850,0.57143
240,0,1,0,1,257,257,0.42857
240,0,1,1,1,190,190,0.57143
240,0,1,1,1,212,212,0.57143
240,3,0,1,1,229,226,0.57143
840,0,1,1,1,798,798,0.57143
480,0,1,1,2,531,531,0.71429
0,-6,0,1,3,-17,-11,0.85714
840,2,0,1,3,830,828,0.85714
0,-28,0,0,3,-1,27,0.14286
840,2,0,0,1,812,810,0.42857
840,9,0,0,1,866,857,0.42857
0,0,1,1,1,28,28,0.57143
240,0,1,1,3,242,242,0.85714
0,8,0,1,1,14,6,0.57143
0,28,0,0,2,17,-11,0.28571
240,0,1,1,1,216,216,0.57143
240,0,1,1,2,267,267,0.71429
0,0,1,1,2,-9,-9,0.71429
480,29,0,0,1,479,450,0.42857
840,0,1,0,1,828,828,0.42857
480,27,0,1,1,489,462,0.57143
0,0,1,1,2,8,8,0.71429
840,-8,0,1,1,846,854,0.57143
840,0,1,1,1,811,811,0.57143
480,-54,0,0,2,455,509,0.28571
0,48,0,0,4,27,-21,0
840,-2,0,1,1,842,844,0.57143
840,31,0,1,1,850,819,0.57143
0,17,0,0,3,0,-17,0.14286
240,0,1,1,1,220,220,0.57143
240,15,0,1,1,258,243,0.57143
0,32,0,0,3,-6,-38,0.14286
840,0,1,1,1,838,838,0.57143
240,0,1,0,1,212,212,0.42857
840,7,0,1,1,850,843,0.57143
0,-47,0,0,3,-10,37,0.14286
840,0,1,0,1,838,838,0.42857
240,0,1,0,1,222,222,0.42857
480,32,0,0,2,519,487,0.28571
840,-42,0,0,2,829,871,0.28571
480,0,1,1,1,497,497,0.57143
0,0,1,1,3,-5,-5,0.85714
0,0,1,1,3,23,23,0.85714
480,0,1,1,3,476,476,0.85714
240,0,1,1,3,219,219,0.85714
0,0,1,1,3,-18,-18,0.85714
840,0,1,1,1,805,805,0.57143
240,0,1,1,3,241,241,0.85714
840,0,1,1,1,840,840,0.57143
0,0,1,1,3,-14,-14,0.85714
840,-22,0,1,1,827,849,0.57143
480,-18,0,0,1,463,481,0.42857
480,-58,0,0,2,469,527,0.28571
840,0,1,1,1,840,840,0.57143
0,0,1,1,3,-34,-34,0.85714
0,0,1,1,4,3,3,1
480,-42,0,0,2,431,473,0.28571
480,0,1,0,2,490,490,0.28571
0,-56,0,0,2,-5,51,0.28571
840,0,1,0,1,831,831,0.42857
0,-17,0,0,1,-3,14,0.42857
240,9,0,1,3,264,255,0.85714
0,0,1,1,2,-52,-52,0.71429
480,-68,0,0,3,448,516,0.14286
240,0,1,1,1,217,217,0.57143
840,0,1,1,1,858,858,0.57143
0,0,1,1,3,-7,-7,0.85714
480,0,1,1,1,460,460,0.57143
480,-15,0,1,2,481,496,0.71429
840,11,0,0,1,867,856,0.42857
480,-21,0,0,2,463,484,0.28571
840,41,0,1,2,850,809,0.71429
840,9,0,0,1,861,852,0.42857
0,0,1,1,3,-18,-18,0.85714
840,-17,0,0,1,859,876,0.42857
840,0,1,1,1,847,847,0.57143
0,-9,0,1,2,5,14,0.71429
480,46,0,0,3,488,442,0.14286
240,0,1,0,2,224,224,0.28571
480,0,1,0,2,447,447,0.28571
0,0,1,1,3,7,7,0.85714
840,0,1,0,2,831,831,0.28571
480,0,1,0,2,453,453,0.28571
480,-10,0,1,3,490,500,0.85714
480,0,1,1,2,435,435,0.71429
480,-14,0,1,1,490,504,0.57143
0,-54,0,0,3,-1,53,0.14286
840,0,1,1,1,806,806,0.57143
480,0,1,1,2,476,476,0.71429
840,-24,0,1,2,840,864,0.71429
480,35,0,0,1,535,500,0.42857
0,0,1,1,3,32,32,0.85714
0,41,0,0,4,15,-26,0
0,0,1,1,2,13,13,0.71429
0,23,0,0,3,39,16,0.14286
480,-62,0,0,3,439,501,0.14286
0,0,1,1,1,-23,-23,0.57143
0,7,0,0,1,4,-3,0.42857
840,-38,0,1,1,817,855,0.57143
840,11,0,1,1,851,840,0.57143
0,0,1,1,2,22,22,0.71429
480,0,1,1,2,469,469,0.71429
480,0,1,1,2,452,452,0.71429
480,0,1,1,2,490,490,0.71429
0,-52,0,0,3,-18,34,0.14286
480,-2,0,1,1,488,490,0.57143
840,23,0,1,2,863,840,0.71429
240,2,0,1,2,250,248,0.71429
0,-71,0,0,3,-35,36,0.14286
0,0,1,1,1,34,34,0.57143
480,4,0,1,1,481,477,0.57143
480,45,0,0,2,526,481,0.28571
240,12,0,0,1,297,285,0.42857
240,3,0,1,1,256,253,0.57143
0,0,1,1,1,1,1,0.57143
480,8,0,0,1,461,453,0.42857
840,0,1,0,1,803,803,0.42857
0,0,1,1,3,1,1,0.85714
0,27,0,0,3,7,-20,0.14286
840,12,0,1,1,873,861,0.57143
840,-28,0,1,1,824,852,0.57143
0,0,1,1,3,26,26,0.85714
240,2,0,1,3,257,255,0.85714
240,51,0,0,3,295,244,0.14286
0,31,0,0,3,33,2,0.14286
0,-30,0,0,3,26,56,0.14286
840,0,1,1,1,871,871,0.57143
0,0,1,1,2,30,30,0.71429
480,-38,0,0,2,463,501,0.28571
480,0,1,1,1,468,468,0.57143
240,0,1,0,2,181,181,0.28571
240,-7,0,1,1,240,247,0.57143
840,0,1,1,1,840,840,0.57143
480,0,1,1,1,480,480,0.57143
240,0,1,1,2,270,270,0.71429
840,-43,0,1,2,836,879,0.71429
480,0,1,1,1,421,421,0.57143
480,67,0,0,3,489,422,0.14286
0,0,1,1,3,-6,-6,0.85714
840,-25,0,1,1,840,865,0.57143
840,-26,0,1,1,810,836,0.57143
480,0,1,1,1,520,520,0.57143
240,-3,0,1,2,253,256,0.71429
480,0,1,0,1,462,462,0.42857
0,-13,0,1,2,-17,-4,0.71429
0,0,1,1,1,-8,-8,0.57143
480,0,1,0,2,490,490,0.28571
0,45,0,0,3,57,12,0.14286
0,11,0,0,2,20,9,0.28571
0,-48,0,0,3,-18,30,0.14286
0,0,1,1,1,-16,-16,0.57143
840,0,1,0,1,812,812,0.42857
840,-31,0,1,1,830,861,0.57143
0,1,0,1,1,-9,-10,0.57143
840,0,1,1,1,812,812,0.57143
240,-18,0,0,1,225,243,0.42857
240,0,1,1,2,281,281,0.71429
240,-25,0,0,1,228,253,0.42857
0,37,0,0,3,29,-8,0.14286
840,5,0,1,1,873,868,0.57143
480,1,0,1,2,495,494,0.71429
480,-11,0,1,1,489,500,0.57143
0,-16,0,0,1,-17,-1,0.42857
840,0,1,1,1,873,873,0.57143
0,9,0,1,1,-8,-17,0.57143
0,-19,0,0,2,11,30,0.28571
0,0,1,1,3,-10,-10,0.85714
480,0,1,1,3,473,473,0.85714
240,0,1,1,3,270,270,0.85714
240,-51,0,0,3,171,222,0.14286
480,-31,0,0,2,473,504,0.28571
240,-10,0,1,1,202,212,0.57143
480,0,1,1,1,507,507,0.57143
480,0,1,1,2,469,469,0.71429
840,0,1,1,1,835,835,0.57143
240,0,1,1,2,216,216,0.71429
240,-19,0,1,1,216,235,0.57143
840,72,0,0,2,914,842,0.28571
240,0,1,1,1,285,285,0.57143
840,-18,0,1,1,827,845,0.57143
480,-54,0,0,2,455,509,0.28571
840,0,1,0,1,868,868,0.42857
240,15,0,0,1,243,228,0.42857
240,0,1,1,1,244,244,0.57143
0,0,1,1,2,-16,-16,0.71429
840,-19,0,0,2,825,844,0.28571
480,19,0,1,2,489,470,0.71429
480,11,0,0,2,484,473,0.28571
240,-11,0,1,1,230,241,0.57143
840,0,1,1,1,833,833,0.57143
480,0,1,1,1,485,485,0.57143
480,0,1,1,1,511,511,0.57143
480,-2,0,0,1,485,487,0.42857
480,0,1,1,1,445,445,0.57143
0,-17,0,0,2,2,19,0.28571
840,6,0,1,1,830,824,0.57143
840,-11,0,0,1,836,847,0.42857
480,4,0,1,1,499,495,0.57143
480,0,1,0,1,494,494,0.42857
0,10,0,0,2,1,-9,0.28571
240,0,1,1,1,243,243,0.57143
480,-30,0,0,2,439,469,0.28571
0,0,1,1,2,8,8,0.71429
840,29,0,1,1,876,847,0.57143
840,-10,0,0,2,834,844,0.28571
240,0,1,0,2,246,246,0.28571
480,29,0,0,2,480,451,0.28571
240,38,0,0,2,283,245,0.28571
0,-11,0,0,2,-21,-10,0.28571
840,-5,0,0,2,832,837,0.28571
240,0,1,0,1,269,269,0.42857
0,0,1,1,1,15,15,0.57143
240,27,0,0,3,267,240,0.14286
240,-30,0,0,3,188,218,0.14286
480,11,0,1,1,470,459,0.57143
240,0,1,1,1,234,234,0.57143
480,-23,0,1,1,497,520,0.57143
840,0,1,1,1,866,866,0.57143
480,0,1,1,1,468,468,0.57143
0,2,0,1,3,10,8,0.85714
840,0,1,1,1,833,833,0.57143
0,0,1,1,1,20,20,0.57143
480,0,1,1,1,466,466,0.57143
240,15,0,1,2,230,215,0.71429
240,8,0,1,2,201,193,0.71429
240,-3,0,1,1,253,256,0.57143
0,0,1,1,3,-18,-18,0.85714
240,0,1,1,1,246,246,0.57143
840,0,1,1,1,858,858,0.57143
0,0,1,1,1,-39,-39,0.57143
480,-57,0,0,3,433,490,0.14286
240,-7,0,0,2,259,266,0.28571
840,0,1,1,1,829,829,0.57143
240,22,0,0,1,242,220,0.42857
480,11,0,0,1,454,443,0.42857
480,-50,0,0,2,472,522,0.28571
480,0,1,1,1,466,466,0.57143
0,30,0,0,3,9,-21,0.14286
840,-6,0,0,1,857,863,0.42857
0,0,1,1,1,-4,-4,0.57143
240,10,0,1,1,239,229,0.57143
840,0,1,1,1,819,819,0.57143
840,43,0,0,2,865,822,0.28571
840,0,1,0,1,859,859,0.42857
480,38,0,0,2,499,461,0.28571
840,0,1,0,1,828,828,0.42857
240,0,1,0,1,244,244,0.42857
840,0,1,0,1,883,883,0.42857
840,0,1,1,1,827,827,0.57143
480,8,0,0,1,501,493,0.42857
240,0,1,1,1,269,269,0.57143
840,17,0,1,1,864,847,0.57143
0,0,1,1,3,13,13,0.85714
840,0,1,1,1,845,845,0.57143
480,-4,0,1,1,493,497,0.57143
480,0,1,1,1,493,493,0.57143
0,-4,0,1,1,-10,-6,0.57143
240,0,1,1,1,247,247,0.57143
0,-14,0,0,1,-3,11,0.42857
240,-9,0,0,1,218,227,0.42857
840,0,1,0,1,867,867,0.42857
840,0,1,0,1,843,843,0.42857
840,0,1,0,1,833,833,0.42857
240,47,0,0,2,245,198,0.28571
480,0,1,0,1,455,455,0.42857
0,-25,0,0,3,13,38,0.14286
0,0,1,1,3,-20,-20,0.85714
480,-21,0,0,1,473,494,0.42857
480,0,1,0,1,495,495,0.42857
480,59,0,0,3,546,487,0.14286
240,0,1,0,2,225,225,0.28571
480,-37,0,0,2,452,489,0.28571
480,0,1,1,1,470,470,0.57143
0,-32,0,0,3,-38,-6,0.14286
480,0,1,0,1,492,492,0.42857
240,-20,0,0,2,277,297,0.28571
240,0,1,0,1,268,268,0.42857
0,0,1,1,3,16,16,0.85714
240,-55,0,0,3,231,286,0.14286
840,0,1,0,1,835,835,0.42857
840,-35,0,0,3,812,847,0.14286
840,0,1,0,1,847,847,0.42857
240,0,1,0,1,226,226,0.42857
240,-25,0,0,3,212,237,0.14286
840,3,0,1,1,808,805,0.57143
240,0,1,1,2,217,217,0.71429
840,0,1,0,1,834,834,0.42857
240,14,0,1,1,224,210,0.57143
240,9,0,1,2,253,244,0.71429
0,14,0,0,2,3,-11,0.28571
480,0,1,1,1,461,461,0.57143
240,0,1,1,1,266,266,0.57143
840,0,1,1,1,811,811,0.57143
480,0,1,0,1,496,496,0.42857
0,21,0,0,3,-2,-23,0.14286
840,0,1,0,1,805,805,0.42857
480,0,1,1,1,461,461,0.57143
0,0,1,1,3,14,14,0.85714
0,39,0,0,3,0,-39,0.14286
480,0,1,1,1,514,514,0.57143
0,30,0,0,2,-14,-44,0.28571
0,50,0,0,3,10,-40,0.14286
0,0,1,1,3,34,34,0.85714
240,0,1,1,2,228,228,0.71429
840,50,0,0,3,866,816,0.14286
840,16,0,0,1,861,845,0.42857
240,87,0,0,3,287,200,0.14286
0,0,1,1,2,-19,-19,0.71429
0,30,0,0,3,46,16,0.14286
480,5,0,0,3,487,482,0.14286
840,0,1,1,1,843,843,0.57143
0,27,0,0,3,-9,-36,0.14286
0,17,0,0,3,-4,-21,0.14286
240,0,1,1,1,249,249,0.57143
480,0,1,1,1,532,532,0.57143
0,0,1,1,1,16,16,0.57143
0,0,1,1,3,8,8,0.85714
480,12,0,0,1,470,458,0.42857
480,0,1,0,1,491,491,0.42857
480,0,1,1,2,470,470,0.71429
480,-10,0,1,1,446,456,0.57143
840,-8,0,1,1,828,836,0.57143
0,-14,0,0,2,25,39,0.28571
0,16,0,0,2,-5,-21,0.28571
840,22,0,0,1,873,851,0.42857
480,33,0,0,2,481,448,0.28571
240,-12,0,1,1,250,262,0.57143
240,0,1,1,1,243,243,0.57143
0,0,1,1,3,0,0,0.85714
480,0,1,1,1,476,476,0.57143
240,0,1,0,1,214,214,0.42857
0,0,1,1,3,5,5,0.85714
840,0,1,0,1,818,818,0.42857
0,-67,0,0,4,-21,46,0
480,-18,0,1,1,456,474,0.57143
240,0,1,0,1,241,241,0.42857
240,0,1,1,3,241,241,0.85714
480,71,0,0,3,473,402,0.14286
840,0,1,0,1,828,828,0.42857
480,-22,0,0,1,477,499,0.42857
0,-33,0,0,3,-23,10,0.14286
480,0,1,0,3,490,490,0.14286
0,-8,0,0,3,1,9,0.14286
480,16,0,1,1,509,493,0.57143
840,-7,0,1,1,806,813,0.57143
480,20,0,1,1,485,465,0.57143
840,4,0,0,1,926,922,0.42857
480,0,1,1,1,471,471,0.57143
240,0,1,1,1,260,260,0.57143
480,-39,0,0,1,427,466,0.42857
0,0,1,1,1,12,12,0.57143
840,-25,0,0,1,826,851,0.42857
840,0,1,0,1,798,798,0.42857
240,0,1,0,2,260,260,0.28571
240,0,1,1,2,283,283,0.71429
0,18,0,0,1,-19,-37,0.42857
480,0,1,0,1,484,484,0.42857
0,0,1,1,3,10,10,0.85714
840,0,1,1,1,828,828,0.57143
840,0,1,0,1,851,851,0.42857
240,0,1,0,1,311,311,0.42857
240,-50,0,0,3,217,267,0.14286
0,0,1,1,3,-11,-11,0.85714
480,-20,0,0,1,455,475,0.42857
480,17,0,0,1,490,473,0.42857
0,22,0,0,2,15,-7,0.28571
480,0,1,0,2,493,493,0.28571
840,0,1,1,1,837,837,0.57143
840,0,1,1,1,821,821,0.57143
840,0,1,1,1,832,832,0.57143
0,-7,0,1,3,0,7,0.85714
840,0,1,1,1,806,806,0.57143
240,-45,0,0,3,226,271,0.14286
840,0,1,0,1,807,807,0.42857
840,-38,0,0,2,831,869,0.28571
480,-47,0,0,2,465,512,0.28571
0,0,1,0,1,0,0,0.42857
0,0,1,1,3,4,4,0.85714
240,0,1,1,3,230,230,0.85714
240,-68,0,0,3,178,246,0.14286
840,22,0,0,1,855,833,0.42857
0,0,1,1,3,-7,-7,0.85714
480,0,1,0,1,482,482,0.42857
840,0,1,1,1,805,805,0.57143
480,35,0,0,1,513,478,0.42857
480,0,1,0,1,466,466,0.42857
0,0,1,0,2,33,33,0.28571
840,16,0,0,1,834,818,0.42857
0,36,0,0,3,13,-23,0.14286
840,0,1,1,1,822,822,0.57143
0,0,1,1,3,-4,-4,0.85714
840,0,1,1,1,846,846,0.57143
0,0,1,1,2,21,21,0.71429
0,-31,0,0,3,15,46,0.14286
840,-51,0,0,2,816,867,0.28571
480,0,1,1,1,515,515,0.57143
480,26,0,0,1,486,460,0.42857
240,-18,0,0,1,223,241,0.42857
480,0,1,0,1,492,492,0.42857
0,1,0,0,1,29,28,0.42857
840,0,1,1,1,835,835,0.57143
240,19,0,0,1,261,242,0.42857
480,0,1,0,1,475,475,0.42857
840,30,0,0,1,865,835,0.42857
840,-23,0,1,1,839,862,0.57143
0,-10,0,0,1,-19,-9,0.42857
0,-89,0,0,4,-49,40,0
0,-7,0,1,3,-20,-13,0.85714
840,-51,0,0,3,782,833,0.14286
840,0,1,1,1,850,850,0.57143
480,0,1,1,1,482,482,0.57143
240,32,0,0,2,261,229,0.28571
480,0,1,1,1,452,452,0.57143
0,0,1,1,1,-11,-11,0.57143
240,10,0,1,2,233,223,0.71429
480,0,1,1,1,514,514,0.57143
480,0,1,1,2,468,468,0.71429
0,-34,0,0,3,4,38,0.14286
840,3,0,0,1,865,862,0.42857
0,0,1,1,3,-31,-31,0.85714
840,28,0,1,1,845,817,0.57143
0,0,1,1,3,-35,-35,0.85714
240,0,1,0,1,229,229,0.42857
240,-17,0,0,2,246,263,0.28571
840,0,1,0,1,859,859,0.42857
240,0,1,0,2,224,224,0.28571
480,0,1,0,1,494,494,0.42857
840,1,0,1,1,823,822,0.57143
0,41,0,0,3,13,-28,0.14286
240,-68,0,0,3,223,291,0.14286
0,0,1,1,2,-27,-27,0.71429
0,0,1,1,1,22,22,0.57143
840,19,0,1,1,884,865,0.57143
840,19,0,0,1,891,872,0.42857
0,0,1,0,1,9,9,0.42857
240,-31,0,0,2,217,248,0.28571
480,64,0,0,2,500,436,0.28571
480,0,1,1,1,477,477,0.57143
240,26,0,0,2,260,234,0.28571
240,-27,0,0,2,235,262,0.28571
840,-27,0,0,2,838,865,0.28571
480,22,0,0,1,452,430,0.42857
0,-24,0,0,2,-46,-22,0.28571
0,0,1,1,1,-30,-30,0.57143
480,37,0,0,2,497,460,0.28571
840,0,1,1,2,844,844,0.71429
240,-7,0,1,1,214,221,0.57143
480,-13,0,0,1,473,486,0.42857
240,42,0,0,2,274,232,0.28571
840,0,1,1,1,852,852,0.57143
240,0,1,0,1,242,242,0.42857
480,11,0,1,1,546,535,0.57143
480,0,1,1,1,516,516,0.57143
0,-2,0,1,3,-12,-10,0.85714
0,0,1,1,3,8,8,0.85714
840,0,1,1,1,872,872,0.57143
0,24,0,0,3,42,18,0.14286
0,0,1,1,3,-8,-8,0.85714
840,0,1,0,1,856,856,0.42857
480,-63,0,0,2,457,520,0.28571
480,0,1,1,1,455,455,0.57143
240,-4,0,1,1,241,245,0.57143
240,64,0,0,3,251,187,0.14286
240,-66,0,0,3,205,271,0.14286
240,0,1,1,1,248,248,0.57143
480,0,1,1,1,467,467,0.57143
480,0,1,1,1,490,490,0.57143
240,0,1,1,2,270,270,0.71429
840,26,0,1,1,852,826,0.57143
240,0,1,1,1,221,221,0.57143
840,0,1,1,1,811,811,0.57143
480,22,0,0,1,490,468,0.42857
240,10,0,0,1,252,242,0.42857
840,-5,0,0,1,888,893,0.42857
480,12,0,0,1,465,453,0.42857
0,13,0,0,2,19,6,0.28571
840,33,0,1,1,839,806,0.57143
480,0,1,1,1,504,504,0.57143
840,-1,0,1,1,839,840,0.57143
480,-19,0,0,1,438,457,0.42857
0,-42,0,0,3,-30,12,0.14286
240,0,1,0,1,223,223,0.42857
840,-12,0,0,1,844,856,0.42857
240,16,0,0,1,244,228,0.42857
240,0,1,1,2,259,259,0.71429
240,0,1,1,2,251,251,0.71429
240,0,1,1,2,231,231,0.71429
840,0,1,1,1,814,814,0.57143
840,16,0,1,1,801,785,0.57143
480,-2,0,1,1,473,475,0.57143
480,-7,0,1,1,454,461,0.57143
240,0,1,1,1,217,217,0.57143
840,0,1,1,1,838,838,0.57143
240,-8,0,1,2,247,255,0.71429
480,0,1,1,1,511,511,0.57143
0,0,1,1,3,7,7,0.85714
0,0,1,1,3,-10,-10,0.85714
480,0,1,1,1,521,521,0.57143
240,53,0,0,3,274,221,0.14286
840,0,1,1,1,836,836,0.57143
480,0,1,1,1,479,479,0.57143
240,0,1,1,1,263,263,0.57143
0,10,0,0,1,19,9,0.42857
480,0,1,1,1,499,499,0.57143
480,-41,0,0,2,452,493,0.28571
0,0,1,1,1,30,30,0.57143
240,0,1,1,1,230,230,0.57143
0,0,1,1,3,-36,-36,0.85714
480,-84,0,0,3,433,517,0.14286
840,0,1,0,1,819,819,0.42857
480,45,0,0,2,481,436,0.28571
480,-37,0,0,1,437,474,0.42857
480,0,1,1,1,499,499,0.57143
840,0,1,1,1,831,831,0.57143
840,0,1,1,1,814,814,0.57143
240,-53,0,0,3,216,269,0.14286
480,0,1,0,1,482,482,0.42857
480,0,1,0,1,472,472,0.42857
480,6,0,1,1,498,492,0.57143
840,28,0,1,1,853,825,0.57143
480,-27,0,0,1,466,493,0.42857
0,0,1,1,1,14,14,0.57143
240,-20,0,0,2,247,267,0.28571
240,-7,0,0,2,233,240,0.28571
480,1,0,0,2,490,489,0.28571
240,0,1,0,2,253,253,0.28571
0,14,0,1,1,28,14,0.57143
240,0,1,1,1,239,239,0.57143
0,0,1,0,1,63,63,0.42857
240,0,1,1,2,306,306,0.71429
240,0,1,1,1,232,232,0.57143
480,0,1,1,1,488,488,0.57143
840,0,1,1,1,849,849,0.57143
0,0,1,1,3,3,3,0.85714
240,0,1,1,1,222,222,0.57143
480,0,1,1,1,466,466,0.57143
480,56,0,0,3,512,456,0.14286
840,-18,0,0,1,808,826,0.42857
240,0,1,1,2,208,208,0.71429
480,0,1,1,1,480,480,0.57143
480,0,1,1,1,481,481,0.57143
0,0,1,1,3,-31,-31,0.85714
0,0,1,0,1,39,39,0.42857
0,-10,0,1,1,29,39,0.57143
0,0,1,1,3,-34,-34,0.85714
240,0,1,1,1,255,255,0.57143
240,-6,0,0,1,223,229,0.42857
480,0,1,0,1,484,484,0.42857
480,0,1,1,1,516,516,0.57143
0,22,0,0,2,4,-18,0.28571
840,55,0,0,2,887,832,0.28571
240,9,0,0,1,235,226,0.42857
0,-37,0,0,3,-21,16,0.14286
240,0,1,1,1,231,231,0.57143
480,-11,0,1,1,450,461,0.57143
480,0,1,0,1,458,458,0.42857
240,0,1,0,1,242,242,0.42857
240,0,1,0,2,202,202,0.28571
240,0,1,0,1,246,246,0.42857
240,-4,0,1,1,261,265,0.57143
0,0,1,1,3,12,12,0.85714
480,0,1,1,1,480,480,0.57143
840,0,1,1,1,874,874,0.57143
0,0,1,1,3,3,3,0.85714
0,-26,0,0,2,-18,8,0.28571
480,-44,0,0,3,452,496,0.14286
840,20,0,1,1,882,862,0.57143
840,0,1,1,1,835,835,0.57143
840,0,1,1,1,843,843,0.57143
840,-11,0,1,1,832,843,0.57143
480,36,0,0,3,525,489,0.14286
480,-67,0,0,2,447,514,0.28571
240,0,1,0,1,267,267,0.42857
240,0,1,1,1,260,260,0.57143
840,0,1,1,1,840,840,0.57143
0,0,1,1,3,-17,-17,0.85714
0,0,1,1,3,-6,-6,0.85714
840,0,1,1,1,851,851,0.57143
240,22,0,0,1,250,228,0.42857
840,17,0,0,1,865,848,0.42857
240,-5,0,1,1,228,233,0.57143
0,16,0,0,1,-23,-39,0.42857
840,0,1,1,1,882,882,0.57143
480,48,0,0,1,497,449,0.42857
0,0,1,1,1,16,16,0.57143
840,0,1,1,1,854,854,0.57143
0,0,1,1,2,-19,-19,0.71429
480,0,1,0,1,441,441,0.42857
240,0,1,1,1,184,184,0.57143
0,0,1,1,2,57,57,0.71429
840,0,1,1,1,803,803,0.57143
0,3,0,1,2,-4,-7,0.71429
240,-17,0,0,1,191,208,0.42857
0,-25,0,0,2,-21,4,0.28571
0,36,0,0,3,17,-19,0.14286
0,-15,0,0,1,-24,-9,0.42857
0,-11,0,0,1,-30,-19,0.42857
240,9,0,1,1,222,213,0.57143
240,0,1,1,1,290,290,0.57143
480,14,0,1,1,529,515,0.57143
0,-37,0,0,3,-14,23,0.14286
240,23,0,1,1,242,219,0.57143
0,22,0,0,3,-9,-31,0.14286
240,0,1,1,1,232,232,0.57143
480,2,0,1,1,470,468,0.57143
840,0,1,0,1,832,832,0.42857
0,0,1,1,3,-16,-16,0.85714
240,0,1,1,1,236,236,0.57143
480,69,0,0,3,537,468,0.14286
240,0,1,1,1,231,231,0.57143
480,0,1,1,1,502,502,0.57143
840,35,0,0,1,834,799,0.42857
840,12,0,1,1,873,861,0.57143
240,4,0,1,1,238,234,0.57143
0,14,0,0,1,48,34,0.42857
840,18,0,0,1,851,833,0.42857
240,0,1,1,1,214,214,0.57143
0,0,1,1,1,55,55,0.57143
240,56,0,0,3,244,188,0.14286
240,0,1,1,1,278,278,0.57143
0,17,0,0,1,15,-2,0.42857
240,-30,0,0,3,239,269,0.14286
480,0,1,0,1,479,479,0.42857
840,51,0,0,1,884,833,0.42857
240,-9,0,0,1,224,233,0.42857
0,-3,0,1,3,-14,-11,0.85714
480,1,0,1,1,475,474,0.57143
0,0,1,1,2,-23,-23,0.71429
240,0,1,1,1,225,225,0.57143
840,21,0,1,1,863,842,0.57143
840,-21,0,1,1,845,866,0.57143
480,0,1,0,1,456,456,0.42857
0,68,0,0,3,20,-48,0.14286
240,-14,0,1,1,223,237,0.57143
240,0,1,1,1,251,251,0.57143
840,0,1,1,1,817,817,0.57143
480,-1,0,0,1,511,512,0.42857
840,-10,0,1,1,840,850,0.57143
240,13,0,1,1,219,206,0.57143
0,0,1,1,3,12,12,0.85714
840,0,1,1,1,841,841,0.57143
0,0,1,1,2,-44,-44,0.71429
240,52,0,0,3,259,207,0.14286
0,0,1,1,2,-13,-13,0.71429
840,-5,0,1,1,830,835,0.57143
0,51,0,0,3,28,-23,0.14286
0,0,1,1,2,-26,-26,0.71429
840,18,0,1,1,862,844,0.57143
480,9,0,1,1,484,475,0.57143
0,47,0,0,2,48,1,0.28571
480,9,0,1,1,478,469,0.57143
240,-15,0,0,2,218,233,0.28571
480,0,1,0,1,458,458,0.42857
0,15,0,0,1,13,-2,0.42857
840,39,0,1,1,840,801,0.57143
0,17,0,1,1,-29,-46,0.57143
0,-14,0,0,2,1,15,0.28571
0,0,1,1,1,64,64,0.57143
0,0,1,1,2,-14,-14,0.71429
240,0,1,1,2,259,259,0.71429
480,0,1,1,1,490,490,0.57143
840,0,1,1,1,869,869,0.57143
0,-10,0,1,2,1,11,0.71429
840,-2,0,1,1,853,855,0.57143
840,-57,0,0,1,815,872,0.42857
0,2,0,1,1,12,10,0.57143
0,-22,0,0,2,-16,6,0.28571
240,-12,0,0,2,238,250,0.28571
240,-5,0,1,1,226,231,0.57143
480,0,1,1,1,457,457,0.57143
480,3,0,0,1,468,465,0.42857
240,0,1,0,1,252,252,0.42857
480,0,1,1,1,451,451,0.57143
480,-32,0,0,1,479,511,0.42857
240,14,0,1,1,239,225,0.57143
480,0,1,1,1,485,485,0.57143
240,0,1,1,1,226,226,0.57143
840,7,0,0,1,818,811,0.42857
240,35,0,0,2,291,256,0.28571
0,0,1,1,2,38,38,0.71429
480,0,1,1,1,511,511,0.57143
0,0,1,0,1,20,20,0.42857
480,0,1,1,1,490,490,0.57143
240,0,1,0,1,260,260,0.42857
0,-16,0,0,1,-20,-4,0.42857
480,0,1,1,1,473,473,0.57143
480,-51,0,0,2,487,538,0.28571
240,0,1,1,1,257,257,0.57143
480,-22,0,0,2,489,511,0.28571
480,0,1,1,1,470,470,0.57143
840,-56,0,0,2,780,836,0.28571
0,0,1,0,2,44,44,0.28571
840,93,0,0,3,901,808,0.14286
0,0,1,1,2,20,20,0.71429
840,-24,0,1,1,832,856,0.57143
840,0,1,1,1,860,860,0.57143
480,-6,0,1,1,468,474,0.57143
240,0,1,1,1,218,218,0.57143
840,0,1,0,1,766,766,0.42857
240,-16,0,0,1,234,250,0.42857
240,12,0,0,1,262,250,0.42857
480,-11,0,1,1,460,471,0.57143
0,19,0,0,1,11,-8,0.42857
840,0,1,1,1,832,832,0.57143
840,-59,0,0,2,827,886,0.28571
240,0,1,1,1,233,233,0.57143
480,36,0,0,3,502,466,0.14286
840,0,1,1,1,818,818,0.57143
0,-28,0,0,2,-18,10,0.28571
840,-30,0,1,1,855,885,0.57143
240,0,1,0,1,248,248,0.42857
480,-2,0,1,1,477,479,0.57143
840,38,0,0,1,858,820,0.42857
480,44,0,0,2,508,464,0.28571
840,0,1,1,1,803,803,0.57143
840,-49,0,0,2,804,853,0.28571
480,3,0,1,1,484,481,0.57143
0,88,0,0,3,85,-3,0.14286
240,0,1,1,1,186,186,0.57143
840,31,0,1,1,853,822,0.57143
240,0,1,0,2,258,258,0.28571
480,-17,0,0,2,486,503,0.28571
840,-27,0,1,1,823,850,0.57143
840,27,0,0,1,848,821,0.42857
240,0,1,0,1,268,268,0.42857
240,-37,0,0,3,194,231,0.14286
840,-50,0,0,3,809,859,0.14286
240,0,1,1,1,231,231,0.57143
240,0,1,0,1,225,225,0.42857
0,-6,0,0,1,12,18,0.42857
840,-2,0,1,1,857,859,0.57143
0,13,0,1,2,7,-6,0.71429
0,-43,0,0,3,-18,25,0.14286
480,-26,0,0,2,483,509,0.28571
480,0,1,1,1,484,484,0.57143
840,0,1,1,1,841,841,0.57143
480,-37,0,0,2,446,483,0.28571
840,0,1,1,2,838,838,0.71429
840,0,1,1,1,863,863,0.57143
840,-32,0,0,1,803,835,0.42857
480,-51,0,0,3,434,485,0.14286
840,0,1,0,1,846,846,0.42857
240,50,0,0,2,303,253,0.28571
240,0,1,0,2,278,278,0.28571
240,30,0,0,2,255,225,0.28571
840,0,1,0,1,832,832,0.42857
240,0,1,0,1,235,235,0.42857
480,0,1,0,1,497,497,0.42857
0,-2,0,1,3,2,4,0.85714
240,0,1,1,1,253,253,0.57143
480,20,0,0,1,505,485,0.42857
0,0,1,1,1,17,17,0.57143
840,30,0,1,1,872,842,0.57143
840,0,1,1,1,826,826,0.57143
0,-14,0,1,1,-33,-19,0.57143
0,-36,0,0,2,-42,-6,0.28571
0,0,1,1,1,3,3,0.57143
240,24,0,0,2,277,253,0.28571
0,0,1,1,3,4,4,0.85714
840,0,1,1,1,865,865,0.57143
240,0,1,0,1,251,251,0.42857
840,0,1,1,1,907,907,0.57143
0,-25,0,0,3,-7,18,0.14286
840,-44,0,0,1,806,850,0.42857
480,-9,0,1,2,454,463,0.71429
240,0,1,1,1,216,216,0.57143
240,0,1,1,2,236,236,0.71429
240,0,1,1,2,204,204,0.71429
0,0,1,1,1,-4,-4,0.57143
240,37,0,0,2,238,201,0.28571
840,0,1,1,1,837,837,0.57143
840,-26,0,0,2,805,831,0.28571
0,0,1,1,2,-33,-33,0.71429
0,26,0,0,2,40,14,0.28571
0,0,1,1,1,10,10,0.57143
840,0,1,0,1,801,801,0.42857
0,0,1,1,1,-7,-7,0.57143
0,0,1,1,1,-28,-28,0.57143
840,0,1,0,1,813,813,0.42857
480,0,1,1,1,497,497,0.57143
0,0,1,1,3,-53,-53,0.85714
840,-51,0,1,1,808,859,0.57143
840,-13,0,1,2,842,855,0.71429
240,0,1,1,2,244,244,0.71429
0,0,1,1,2,-16,-16,0.71429
840,-19,0,1,1,825,844,0.57143
480,19,0,1,1,489,470,0.57143
480,11,0,1,1,484,473,0.57143
240,-11,0,0,1,230,241,0.42857
840,0,1,1,1,833,833,0.57143
480,0,1,1,1,485,485,0.57143
480,0,1,1,1,511,511,0.57143
480,-2,0,1,1,485,487,0.57143
480,0,1,1,1,445,445,0.57143
0,-17,0,0,3,2,19,0.14286
840,6,0,1,1,830,824,0.57143
840,-11,0,0,1,836,847,0.42857
480,4,0,1,1,499,495,0.57143
480,0,1,1,1,494,494,0.57143
0,10,0,1,1,1,-9,0.57143
240,0,1,1,1,243,243,0.57143
480,-30,0,0,1,439,469,0.42857
0,0,1,1,1,8,8,0.57143
840,29,0,1,1,876,847,0.57143
840,-10,0,1,1,834,844,0.57143
240,0,1,1,1,246,246,0.57143
480,29,0,0,1,480,451,0.42857
240,38,0,0,3,283,245,0.14286
0,-11,0,0,3,-21,-10,0.14286
840,-5,0,1,1,832,837,0.57143
240,0,1,1,2,269,269,0.71429
0,0,1,1,2,15,15,0.71429
240,27,0,0,2,267,240,0.28571
240,-30,0,0,3,188,218,0.14286
480,11,0,1,1,470,459,0.57143
240,0,1,0,1,234,234,0.42857
480,-23,0,1,1,497,520,0.57143
840,0,1,1,1,866,866,0.57143
480,0,1,1,1,468,468,0.57143
0,2,0,1,2,10,8,0.71429
840,0,1,1,2,833,833,0.71429
0,0,1,1,3,20,20,0.85714
480,0,1,1,1,466,466,0.57143
240,15,0,0,1,230,215,0.42857
240,8,0,1,1,201,193,0.57143
240,-3,0,0,2,253,256,0.28571
0,0,1,1,3,-18,-18,0.85714
240,0,1,1,1,246,246,0.57143
840,0,1,0,1,858,858,0.42857
0,0,1,1,3,-39,-39,0.85714
480,-57,0,0,3,433,490,0.14286
240,-7,0,0,2,259,266,0.28571
840,0,1,0,2,829,829,0.28571
240,22,0,1,2,242,220,0.71429
480,11,0,1,1,454,443,0.57143
480,-50,0,0,2,472,522,0.28571
480,0,1,1,1,466,466,0.57143
0,30,0,0,3,9,-21,0.14286
840,-6,0,1,1,857,863,0.57143
0,0,1,1,3,-4,-4,0.85714
240,10,0,1,2,239,229,0.71429
840,0,1,1,1,819,819,0.57143
840,43,0,0,1,865,822,0.42857
840,0,1,0,1,859,859,0.42857
480,38,0,0,3,499,461,0.14286
840,0,1,0,1,828,828,0.42857
240,0,1,1,1,244,244,0.57143
840,0,1,1,1,883,883,0.57143
840,0,1,1,1,827,827,0.57143
480,8,0,1,1,501,493,0.57143
240,0,1,1,1,269,269,0.57143
840,17,0,0,2,864,847,0.28571
0,0,1,1,3,13,13,0.85714
840,0,1,1,1,845,845,0.57143
480,-4,0,1,1,493,497,0.57143
480,0,1,0,1,493,493,0.42857
0,-4,0,1,1,-10,-6,0.57143
240,0,1,1,2,247,247,0.71429
0,-14,0,0,3,-3,11,0.14286
240,-9,0,0,2,218,227,0.28571
840,0,1,1,1,867,867,0.57143
840,0,1,1,1,843,843,0.57143
840,0,1,0,1,833,833,0.42857
240,47,0,0,3,245,198,0.14286
480,0,1,0,1,455,455,0.42857
0,-25,0,0,3,13,38,0.14286
0,0,1,1,1,-20,-20,0.57143
480,-21,0,0,2,473,494,0.28571
480,0,1,1,1,495,495,0.57143
480,59,0,0,3,546,487,0.14286
240,0,1,0,1,225,225,0.42857
480,-37,0,0,1,452,489,0.42857
480,0,1,0,1,470,470,0.42857
0,-32,0,0,3,-38,-6,0.14286
480,0,1,1,2,492,492,0.71429
240,-20,0,0,2,277,297,0.28571
240,0,1,1,1,268,268,0.57143
0,0,1,1,3,16,16,0.85714
240,-55,0,0,3,231,286,0.14286
840,0,1,1,1,835,835,0.57143
840,-35,0,0,2,812,847,0.28571
840,0,1,1,1,847,847,0.57143
240,0,1,1,1,226,226,0.57143
240,-25,0,0,3,212,237,0.14286
840,3,0,0,1,808,805,0.42857
240,0,1,0,1,217,217,0.42857
840,0,1,1,1,834,834,0.57143
240,14,0,0,2,224,210,0.28571
240,9,0,0,1,253,244,0.42857
0,14,0,1,1,3,-11,0.57143
480,0,1,1,1,461,461,0.57143
240,0,1,1,1,266,266,0.57143
840,0,1,1,1,811,811,0.57143
480,0,1,0,1,496,496,0.42857
0,21,0,0,3,-2,-23,0.14286
840,0,1,1,1,805,805,0.57143
480,0,1,1,1,461,461,0.57143
0,0,1,1,3,14,14,0.85714
0,39,0,0,3,0,-39,0.14286
480,0,1,1,1,514,514,0.57143
0,30,0,0,3,-14,-44,0.14286
0,50,0,0,4,10,-40,0
0,0,1,1,2,34,34,0.71429
240,0,1,0,1,228,228,0.42857
840,50,0,0,3,866,816,0.14286
840,16,0,0,2,861,845,0.28571
240,87,0,0,4,287,200,0
0,0,1,1,2,-19,-19,0.71429
0,30,0,0,3,46,16,0.14286
480,5,0,0,1,487,482,0.42857
840,0,1,0,1,843,843,0.42857
0,27,0,0,3,-9,-36,0.14286
0,17,0,0,3,-4,-21,0.14286
240,0,1,1,1,249,249,0.57143
480,0,1,0,1,532,532,0.42857
0,0,1,1,3,16,16,0.85714
0,0,1,1,3,8,8,0.85714
480,12,0,1,1,470,458,0.57143
480,0,1,0,1,491,491,0.42857
480,0,1,1,2,470,470,0.71429
480,-10,0,1,1,446,456,0.57143
840,-8,0,1,1,828,836,0.57143
0,-14,0,0,2,25,39,0.28571
0,16,0,1,1,-5,-21,0.57143
840,22,0,0,1,873,851,0.42857
480,33,0,0,1,481,448,0.42857
240,-12,0,0,1,250,262,0.42857
240,0,1,1,1,243,243,0.57143
0,0,1,1,1,0,0,0.57143
480,0,1,1,1,476,476,0.57143
240,0,1,1,1,214,214,0.57143
0,0,1,1,3,5,5,0.85714
840,0,1,1,1,818,818,0.57143
0,-67,0,0,4,-21,46,0
480,-18,0,1,1,456,474,0.57143
240,0,1,1,1,241,241,0.57143
240,0,1,1,1,241,241,0.57143
480,71,0,0,3,473,402,0.14286
840,0,1,0,1,828,828,0.42857
480,-22,0,1,1,477,499,0.57143
0,-33,0,0,3,-23,10,0.14286
480,0,1,1,1,490,490,0.57143
0,-8,0,0,1,1,9,0.42857
480,16,0,0,1,509,493,0.42857
840,-7,0,1,1,806,813,0.57143
480,20,0,0,2,485,465,0.28571
840,4,0,0,2,926,922,0.28571
480,0,1,0,1,471,471,0.42857
240,0,1,1,2,260,260,0.71429
480,-39,0,0,1,427,466,0.42857
0,0,1,1,3,12,12,0.85714
840,-25,0,0,1,826,851,0.42857
840,0,1,1,1,798,798,0.57143
240,0,1,1,2,260,260,0.71429
240,0,1,1,1,283,283,0.57143
0,18,0,0,1,-19,-37,0.42857
480,0,1,1,1,484,484,0.57143
0,0,1,1,3,10,10,0.85714
840,0,1,0,1,828,828,0.42857
840,0,1,1,1,851,851,0.57143
240,0,1,0,1,311,311,0.42857
240,-50,0,0,3,217,267,0.14286
0,0,1,1,2,-11,-11,0.71429
480,-20,0,0,1,455,475,0.42857
480,17,0,0,2,490,473,0.28571
0,22,0,0,3,15,-7,0.14286
480,0,1,1,1,493,493,0.57143
840,0,1,1,1,837,837,0.57143
840,0,1,1,1,821,821,0.57143
840,0,1,1,1,832,832,0.57143
0,-7,0,1,3,0,7,0.85714
840,0,1,1,1,806,806,0.57143
240,-45,0,0,3,226,271,0.14286
840,0,1,1,1,807,807,0.57143
840,-38,0,0,2,831,869,0.28571
480,-47,0,0,3,465,512,0.14286
0,0,1,1,3,0,0,0.85714
0,0,1,1,1,4,4,0.57143
240,0,1,1,1,230,230,0.57143
240,-68,0,0,3,178,246,0.14286
840,22,0,1,1,855,833,0.57143
0,0,1,1,2,-7,-7,0.71429
480,0,1,0,1,482,482,0.42857
840,0,1,0,1,805,805,0.42857
480,35,0,0,1,513,478,0.42857
480,0,1,1,1,466,466,0.57143
0,0,1,1,2,33,33,0.71429
840,16,0,0,2,834,818,0.28571
0,36,0,0,3,13,-23,0.14286
840,0,1,1,1,822,822,0.57143
0,0,1,1,1,-4,-4,0.57143
840,0,1,1,1,846,846,0.57143
0,0,1,1,2,21,21,0.71429
0,-31,0,0,3,15,46,0.14286
840,-51,0,0,2,816,867,0.28571
480,0,1,1,1,515,515,0.57143
480,26,0,0,2,486,460,0.28571
240,-18,0,0,2,223,241,0.28571
480,0,1,1,1,492,492,0.57143
0,1,0,1,2,29,28,0.71429
840,0,1,1,1,835,835,0.57143
240,19,0,1,3,261,242,0.85714
480,0,1,1,1,475,475,0.57143
840,30,0,0,1,865,835,0.42857
840,-23,0,0,1,839,862,0.42857
0,-10,0,0,1,-19,-9,0.42857
0,-89,0,0,4,-49,40,0
0,-7,0,0,1,-20,-13,0.42857
840,-51,0,0,1,782,833,0.42857
840,0,1,1,1,850,850,0.57143
480,0,1,1,1,482,482,0.57143
240,32,0,0,2,261,229,0.28571
480,0,1,1,1,452,452,0.57143
0,0,1,1,1,-11,-11,0.57143
240,10,0,1,1,233,223,0.57143
480,0,1,1,1,514,514,0.57143
480,0,1,1,1,468,468,0.57143
0,-34,0,0,3,4,38,0.14286
840,3,0,1,1,865,862,0.57143
0,0,1,1,1,-31,-31,0.57143
840,28,0,1,1,845,817,0.57143
0,0,1,1,2,-35,-35,0.71429
240,0,1,1,2,229,229,0.71429
240,-17,0,0,2,246,263,0.28571
840,0,1,1,1,859,859,0.57143
240,0,1,0,1,224,224,0.42857
480,0,1,1,1,494,494,0.57143
840,1,0,1,1,823,822,0.57143
0,41,0,0,3,13,-28,0.14286
240,-68,0,0,4,223,291,0
0,0,1,1,1,-27,-27,0.57143
0,0,1,1,1,22,22,0.57143
840,19,0,1,1,884,865,0.57143
840,19,0,1,1,891,872,0.57143
0,0,1,1,1,9,9,0.57143
240,-31,0,0,3,217,248,0.14286
480,64,0,0,3,500,436,0.14286
480,0,1,0,1,477,477,0.42857
240,26,0,0,3,260,234,0.14286
240,-27,0,0,3,235,262,0.14286
840,-27,0,0,1,838,865,0.42857
480,22,0,1,1,452,430,0.57143
0,-24,0,0,2,-46,-22,0.28571
0,0,1,1,2,-30,-30,0.71429
480,37,0,0,1,497,460,0.42857
840,0,1,1,2,844,844,0.71429
240,-7,0,1,1,214,221,0.57143
480,-13,0,1,1,473,486,0.57143
240,42,0,0,2,274,232,0.28571
840,0,1,0,1,852,852,0.42857
240,0,1,1,1,242,242,0.57143
480,11,0,1,1,546,535,0.57143
480,0,1,1,1,516,516,0.57143
0,-2,0,1,2,-12,-10,0.71429
0,0,1,1,2,8,8,0.71429
840,0,1,1,1,872,872,0.57143
0,24,0,0,2,42,18,0.28571
0,0,1,1,2,-8,-8,0.71429
840,0,1,1,1,856,856,0.57143
480,-63,0,0,2,457,520,0.28571
480,0,1,1,1,455,455,0.57143
240,-4,0,1,1,241,245,0.57143
240,64,0,0,3,251,187,0.14286
240,-66,0,0,4,205,271,0
240,0,1,0,1,248,248,0.42857
480,0,1,1,2,467,467,0.71429
480,0,1,1,2,490,490,0.71429
240,0,1,1,2,270,270,0.71429
840,26,0,1,1,852,826,0.57143
240,0,1,1,2,221,221,0.71429
840,0,1,1,1,811,811,0.57143
480,22,0,1,1,490,468,0.57143
240,10,0,0,1,252,242,0.42857
840,-5,0,1,1,888,893,0.57143
480,12,0,1,1,465,453,0.57143
0,13,0,0,2,19,6,0.28571
840,33,0,0,2,839,806,0.28571
480,0,1,0,1,504,504,0.42857
840,-1,0,1,1,839,840,0.57143
480,-19,0,1,1,438,457,0.57143
0,-42,0,0,2,-30,12,0.28571
240,0,1,1,2,223,223,0.71429
840,-12,0,1,1,844,856,0.57143
240,16,0,1,2,244,228,0.71429
240,0,1,1,1,259,259,0.57143
240,0,1,0,1,251,251,0.42857
240,0,1,1,1,231,231,0.57143
840,0,1,1,1,814,814,0.57143
840,16,0,1,1,801,785,0.57143
480,-2,0,1,1,473,475,0.57143
480,-7,0,1,1,454,461,0.57143
240,0,1,1,1,217,217,0.57143
840,0,1,1,1,838,838,0.57143
240,-8,0,1,1,247,255,0.57143
480,0,1,1,1,511,511,0.57143
0,0,1,1,3,7,7,0.85714
0,0,1,1,3,-10,-10,0.85714
480,0,1,1,1,521,521,0.57143
240,53,0,0,3,274,221,0.14286
840,0,1,1,1,836,836,0.57143
480,0,1,1,1,479,479,0.57143
240,0,1,1,1,263,263,0.57143
0,10,0,0,1,19,9,0.42857
480,0,1,1,1,499,499,0.57143
480,-41,0,1,1,452,493,0.57143
0,0,1,1,1,30,30,0.57143
240,0,1,0,1,230,230,0.42857
0,0,1,1,1,-36,-36,0.57143
480,-84,0,0,3,433,517,0.14286
840,0,1,1,1,819,819,0.57143
480,45,0,0,3,481,436,0.14286
480,-37,0,0,2,437,474,0.28571
480,0,1,1,1,499,499,0.57143
840,0,1,1,1,831,831,0.57143
840,0,1,1,1,814,814,0.57143
240,-53,0,0,3,216,269,0.14286
480,0,1,1,2,482,482,0.71429
480,0,1,1,1,472,472,0.57143
480,6,0,1,2,498,492,0.71429
840,28,0,1,1,853,825,0.57143
480,-27,0,0,2,466,493,0.28571
0,0,1,1,3,14,14,0.85714
240,-20,0,0,1,247,267,0.42857
240,-7,0,1,1,233,240,0.57143
480,1,0,0,2,490,489,0.28571
240,0,1,1,1,253,253,0.57143
0,14,0,0,1,28,14,0.42857
240,0,1,1,1,239,239,0.57143
0,0,1,1,2,63,63,0.71429
240,0,1,1,2,306,306,0.71429
240,0,1,1,2,232,232,0.71429
480,0,1,1,2,488,488,0.71429
840,0,1,1,1,849,849,0.57143
0,0,1,1,3,3,3,0.85714
240,0,1,1,1,222,222,0.57143
480,0,1,1,1,466,466,0.57143
480,56,0,0,3,512,456,0.14286
840,-18,0,0,1,808,826,0.42857
240,0,1,0,1,208,208,0.42857
480,0,1,0,1,480,480,0.42857
480,0,1,0,1,481,481,0.42857
0,0,1,1,3,-31,-31,0.85714
0,0,1,1,1,39,39,0.57143
0,-10,0,0,2,29,39,0.28571
0,0,1,1,1,-34,-34,0.57143
240,0,1,1,1,255,255,0.57143
240,-6,0,0,2,223,229,0.28571
480,0,1,1,1,484,484,0.57143
480,0,1,1,1,516,516,0.57143
0,22,0,0,2,4,-18,0.28571
840,55,0,0,2,887,832,0.28571
240,9,0,1,1,235,226,0.57143
0,-37,0,0,3,-21,16,0.14286
240,0,1,1,1,231,231,0.57143
480,-11,0,1,1,450,461,0.57143
480,0,1,1,1,458,458,0.57143
240,0,1,1,1,242,242,0.57143
240,0,1,1,1,202,202,0.57143
240,0,1,1,1,246,246,0.57143
240,-4,0,1,1,261,265,0.57143
0,0,1,1,1,12,12,0.57143
480,0,1,1,1,480,480,0.57143
840,0,1,1,1,874,874,0.57143
0,0,1,1,3,3,3,0.85714
0,-26,0,0,3,-18,8,0.14286
480,-44,0,0,2,452,496,0.28571
840,20,0,0,1,882,862,0.42857
840,0,1,0,1,835,835,0.42857
840,0,1,0,1,843,843,0.42857
840,-11,0,1,1,832,843,0.57143
480,36,0,0,2,525,489,0.28571
480,-67,0,0,3,447,514,0.14286
240,0,1,1,1,267,267,0.57143
240,0,1,1,1,260,260,0.57143
840,0,1,0,1,840,840,0.42857
0,0,1,1,3,-17,-17,0.85714
0,0,1,1,3,-6,-6,0.85714
840,0,1,1,1,851,851,0.57143
240,22,0,0,2,250,228,0.28571
840,17,0,1,1,865,848,0.57143
240,-5,0,0,1,228,233,0.42857
0,16,0,0,1,-23,-39,0.42857
840,0,1,1,1,882,882,0.57143
480,48,0,0,2,497,449,0.28571
0,0,1,1,3,16,16,0.85714
840,0,1,1,1,854,854,0.57143
0,0,1,1,1,-19,-19,0.57143
480,0,1,0,1,441,441,0.42857
240,0,1,1,1,184,184,0.57143
0,0,1,1,2,57,57,0.71429
840,0,1,1,1,803,803,0.57143
0,3,0,1,3,-4,-7,0.85714
240,-17,0,0,1,191,208,0.42857
0,-25,0,0,3,-21,4,0.14286
0,36,0,0,3,17,-19,0.14286
0,-15,0,0,3,-24,-9,0.14286
0,-11,0,0,3,-30,-19,0.14286
240,9,0,1,1,222,213,0.57143
240,0,1,1,1,290,290,0.57143
480,14,0,1,1,529,515,0.57143
0,-37,0,0,3,-14,23,0.14286
240,23,0,0,2,242,219,0.28571
0,22,0,0,2,-9,-31,0.28571
240,0,1,1,1,232,232,0.57143
480,2,0,1,2,470,468,0.71429
840,0,1,1,1,832,832,0.57143
0,0,1,1,1,-16,-16,0.57143
240,0,1,1,1,236,236,0.57143
480,69,0,0,3,537,468,0.14286
240,0,1,1,1,231,231,0.57143
480,0,1,1,1,502,502,0.57143
840,35,0,1,1,834,799,0.57143
840,12,0,1,1,873,861,0.57143
240,4,0,1,1,238,234,0.57143
0,14,0,0,1,48,34,0.42857
840,18,0,1,1,851,833,0.57143
240,0,1,1,1,214,214,0.57143
0,0,1,1,2,55,55,0.71429
240,56,0,0,3,244,188,0.14286
240,0,1,0,1,278,278,0.42857
0,17,0,0,2,15,-2,0.28571
240,-30,0,0,3,239,269,0.14286
480,0,1,1,1,479,479,0.57143
840,51,0,0,2,884,833,0.28571
240,-9,0,1,1,224,233,0.57143
0,-3,0,1,1,-14,-11,0.57143
480,1,0,1,1,475,474,0.57143
0,0,1,1,1,-23,-23,0.57143
240,0,1,1,1,225,225,0.57143
840,21,0,1,1,863,842,0.57143
840,-21,0,0,1,845,866,0.42857
480,0,1,1,1,456,456,0.57143
0,68,0,0,3,20,-48,0.14286
240,-14,0,0,1,223,237,0.42857
240,0,1,0,1,251,251,0.42857
840,0,1,0,1,817,817,0.42857
480,-1,0,1,1,511,512,0.57143
840,-10,0,0,1,840,850,0.42857
240,13,0,1,1,219,206,0.57143
0,0,1,1,1,12,12,0.57143
840,0,1,1,1,841,841,0.57143
0,0,1,1,1,-44,-44,0.57143
240,52,0,0,3,259,207,0.14286
0,0,1,1,1,-13,-13,0.57143
840,-5,0,1,1,830,835,0.57143
0,51,0,0,3,28,-23,0.14286
0,0,1,1,1,-26,-26,0.57143
840,18,0,1,1,862,844,0.57143
480,9,0,0,1,484,475,0.42857
0,47,0,0,3,48,1,0.14286
480,9,0,1,1,478,469,0.57143
240,-15,0,0,2,218,233,0.28571
480,0,1,0,1,458,458,0.42857
0,15,0,1,1,13,-2,0.57143
840,39,0,1,1,840,801,0.57143
0,17,0,0,1,-29,-46,0.42857
0,-14,0,0,2,1,15,0.28571
0,0,1,1,1,64,64,0.57143
0,0,1,1,3,-14,-14,0.85714
240,0,1,1,1,259,259,0.57143
480,0,1,1,1,490,490,0.57143
840,0,1,0,1,869,869,0.42857
0,-10,0,0,1,1,11,0.42857
840,-2,0,1,1,853,855,0.57143
840,-57,0,0,1,815,872,0.42857
0,2,0,1,2,12,10,0.71429
0,-22,0,0,2,-16,6,0.28571
240,-12,0,0,2,238,250,0.28571
240,-5,0,0,1,226,231,0.42857
480,0,1,1,1,457,457,0.57143
480,3,0,1,1,468,465,0.57143
240,0,1,1,1,252,252,0.57143
480,0,1,0,2,451,451,0.28571
480,-32,0,0,1,479,511,0.42857
240,14,0,1,1,239,225,0.57143
480,0,1,1,1,485,485,0.57143
240,0,1,1,1,226,226,0.57143
840,7,0,1,1,818,811,0.57143
240,35,0,0,1,291,256,0.42857
0,0,1,1,1,38,38,0.57143
480,0,1,0,1,511,511,0.42857
0,0,1,1,1,20,20,0.57143
480,0,1,1,1,490,490,0.57143
240,0,1,1,1,260,260,0.57143
0,-16,0,0,1,-20,-4,0.42857
480,0,1,1,1,473,473,0.57143
480,-51,0,0,1,487,538,0.42857
240,0,1,0,1,257,257,0.42857
480,-22,0,0,1,489,511,0.42857
480,0,1,1,1,470,470,0.57143
840,-56,0,0,2,780,836,0.28571
0,0,1,0,1,44,44,0.42857
840,93,0,0,3,901,808,0.14286
0,0,1,1,1,20,20,0.57143
840,-24,0,0,1,832,856,0.42857
840,0,1,1,1,860,860,0.57143
480,-6,0,1,1,468,474,0.57143
240,0,1,1,1,218,218,0.57143
840,0,1,1,1,766,766,0.57143
240,-16,0,1,1,234,250,0.57143
240,12,0,1,1,262,250,0.57143
480,-11,0,1,2,460,471,0.71429
0,19,0,0,2,11,-8,0.28571
840,0,1,1,1,832,832,0.57143
840,-59,0,0,2,827,886,0.28571
240,0,1,0,1,233,233,0.42857
480,36,0,0,2,502,466,0.28571
840,0,1,0,1,818,818,0.42857
0,-28,0,0,3,-18,10,0.14286
840,-30,0,1,1,855,885,0.57143
240,0,1,1,1,248,248,0.57143
480,-2,0,1,1,477,479,0.57143
840,38,0,0,1,858,820,0.42857
480,44,0,0,3,508,464,0.14286
840,0,1,1,1,803,803,0.57143
840,-49,0,0,1,804,853,0.42857
480,3,0,1,1,484,481,0.57143
0,88,0,0,3,85,-3,0.14286
240,0,1,1,1,186,186,0.57143
840,31,0,1,1,853,822,0.57143
240,0,1,1,2,258,258,0.71429
480,-17,0,1,2,486,503,0.71429
840,-27,0,1,1,823,850,0.57143
840,27,0,1,1,848,821,0.57143
240,0,1,1,1,268,268,0.57143
240,-37,0,0,2,194,231,0.28571
840,-50,0,0,2,809,859,0.28571
240,0,1,0,1,231,231,0.42857
240,0,1,0,1,225,225,0.42857
0,-6,0,0,1,12,18,0.42857
840,-2,0,0,1,857,859,0.42857
0,13,0,1,1,7,-6,0.57143
0,-43,0,0,3,-18,25,0.14286
480,-26,0,0,1,483,509,0.42857
480,0,1,1,1,484,484,0.57143
840,0,1,1,1,841,841,0.57143
480,-37,0,0,1,446,483,0.42857
840,0,1,0,1,838,838,0.42857
840,0,1,0,1,863,863,0.42857
840,-32,0,0,1,803,835,0.42857
480,-51,0,0,2,434,485,0.28571
840,0,1,1,1,846,846,0.57143
240,50,0,0,3,303,253,0.14286
240,0,1,0,2,278,278,0.28571
240,30,0,0,1,255,225,0.42857
840,0,1,1,1,832,832,0.57143
240,0,1,1,2,235,235,0.71429
480,0,1,1,2,497,497,0.71429
0,-2,0,0,1,2,4,0.42857
240,0,1,1,2,253,253,0.71429
480,20,0,0,1,505,485,0.42857
0,0,1,1,2,17,17,0.71429
840,30,0,0,2,872,842,0.28571
840,0,1,0,1,826,826,0.42857
0,-14,0,0,2,-33,-19,0.28571
0,-36,0,0,4,-42,-6,0
0,0,1,1,3,3,3,0.85714
240,24,0,1,1,277,253,0.57143
0,0,1,1,2,4,4,0.71429
840,0,1,0,2,865,865,0.28571
240,0,1,1,1,251,251,0.57143
840,0,1,0,1,907,907,0.42857
0,-25,0,0,2,-7,18,0.28571
840,-44,0,1,2,806,850,0.71429
480,-9,0,1,1,454,463,0.57143
240,0,1,1,1,216,216,0.57143
240,0,1,1,1,236,236,0.57143
240,0,1,1,1,204,204,0.57143
0,0,1,0,1,-4,-4,0.42857
240,37,0,1,1,238,201,0.57143
840,0,1,0,1,837,837,0.42857
840,-26,0,0,1,805,831,0.42857
0,0,1,1,1,-33,-33,0.57143
0,26,0,0,2,40,14,0.28571
0,0,1,1,1,10,10,0.57143
840,0,1,1,1,801,801,0.57143
0,0,1,1,2,-7,-7,0.71429
0,0,1,1,2,-28,-28,0.71429
840,0,1,1,1,813,813,0.57143
480,0,1,0,1,497,497,0.42857
0,0,1,1,1,-53,-53,0.57143
840,-51,0,0,1,808,859,0.42857
840,-13,0,1,1,842,855,0.57143
240,-25,0,0,3,198,223,0.14286
240,0,1,1,1,202,202,0.57143
840,0,1,1,1,835,835,0.57143
240,0,1,1,1,286,286,0.57143
840,20,0,1,1,835,815,0.57143
0,-26,0,0,3,-33,-7,0.14286
0,-26,0,0,3,-1,25,0.14286
480,35,0,0,2,504,469,0.28571
840,0,1,1,1,812,812,0.57143
240,0,1,1,1,246,246,0.57143
0,35,0,0,3,1,-34,0.14286
840,14,0,1,1,825,811,0.57143
480,-36,0,0,1,465,501,0.42857
480,0,1,1,1,537,537,0.57143
840,8,0,1,1,844,836,0.57143
0,53,0,0,4,39,-14,0
480,-9,0,1,2,482,491,0.71429
0,0,1,1,3,21,21,0.85714
840,-26,0,1,1,838,864,0.57143
240,0,1,1,1,271,271,0.57143
480,0,1,1,1,508,508,0.57143
0,0,1,1,3,-13,-13,0.85714
0,0,1,1,3,-1,-1,0.85714
480,0,1,1,1,465,465,0.57143
240,32,0,0,1,262,230,0.42857
480,0,1,1,2,450,450,0.71429
0,14,0,0,1,-6,-20,0.42857
240,15,0,1,1,266,251,0.57143
840,-34,0,1,1,827,861,0.57143
480,0,1,1,1,494,494,0.57143
0,0,1,1,2,6,6,0.71429
0,0,1,1,3,5,5,0.85714
0,14,0,0,2,-4,-18,0.28571
240,40,0,0,3,267,227,0.14286
480,-8,0,1,1,497,505,0.57143
840,0,1,0,1,873,873,0.42857
0,0,1,1,3,-27,-27,0.85714
480,87,0,0,3,533,446,0.14286
480,19,0,0,1,493,474,0.42857
240,-66,0,0,3,231,297,0.14286
240,0,1,1,1,237,237,0.57143
480,0,1,1,1,483,483,0.57143
840,0,1,1,1,836,836,0.57143
840,0,1,1,1,831,831,0.57143
0,0,1,1,3,-0,-0,0.85714
240,-12,0,0,1,238,250,0.42857
240,9,0,1,3,241,232,0.85714
240,5,0,0,1,220,215,0.42857
240,0,1,0,1,242,242,0.42857
480,0,1,1,1,440,440,0.57143
0,40,0,0,4,27,-13,0
840,0,1,1,1,808,808,0.57143
240,4,0,1,1,223,219,0.57143
480,32,0,0,1,480,448,0.42857
840,-18,0,0,1,772,790,0.42857
840,5,0,1,1,829,824,0.57143
840,0,1,1,1,852,852,0.57143
840,46,0,0,1,876,830,0.42857
240,-4,0,1,2,212,216,0.71429
240,0,1,1,2,228,228,0.71429
240,-3,0,1,2,233,236,0.71429
0,0,1,1,3,11,11,0.85714
0,-15,0,0,2,-9,6,0.28571
240,0,1,1,1,269,269,0.57143
0,0,1,1,1,47,47,0.57143
240,-7,0,1,1,264,271,0.57143
480,0,1,1,1,463,463,0.57143
240,31,0,0,3,256,225,0.14286
240,0,1,1,1,264,264,0.57143
480,0,1,0,1,457,457,0.42857
840,0,1,1,1,838,838,0.57143
240,0,1,1,1,281,281,0.57143
240,0,1,1,1,171,171,0.57143
480,0,1,1,1,510,510,0.57143
240,18,0,0,1,259,241,0.42857
480,0,1,1,1,439,439,0.57143
240,43,0,0,3,263,220,0.14286
0,-8,0,0,1,-9,-1,0.42857
840,0,1,1,1,805,805,0.57143
840,0,1,1,1,886,886,0.57143
840,0,1,0,1,885,885,0.42857
0,-33,0,0,3,4,37,0.14286
0,-16,0,0,2,-0,16,0.28571
240,0,1,1,2,243,243,0.71429
240,0,1,1,1,249,249,0.57143
840,0,1,1,1,850,850,0.57143
840,0,1,1,1,840,840,0.57143
480,-31,0,0,2,441,472,0.28571
840,0,1,0,1,832,832,0.42857
240,-17,0,0,4,221,238,0
840,-1,0,1,1,877,878,0.57143
840,0,1,0,1,889,889,0.42857
240,0,1,1,1,266,266,0.57143
840,0,1,0,1,828,828,0.42857
0,0,1,1,3,3,3,0.85714
480,-13,0,1,1,437,450,0.57143
840,-20,0,0,1,826,846,0.42857
240,48,0,0,3,278,230,0.14286
840,0,1,1,1,832,832,0.57143
840,0,1,1,1,831,831,0.57143
840,67,0,0,2,867,800,0.28571
840,0,1,1,1,838,838,0.57143
840,-96,0,0,3,799,895,0.14286
840,29,0,1,1,862,833,0.57143
840,0,1,1,1,838,838,0.57143
840,0,1,1,1,811,811,0.57143
840,-3,0,1,1,864,867,0.57143
240,0,1,1,1,239,239,0.57143
480,-45,0,0,2,442,487,0.28571
0,22,0,0,3,8,-14,0.14286
840,0,1,1,1,823,823,0.57143
840,39,0,0,1,861,822,0.42857
480,0,1,1,1,432,432,0.57143
840,0,1,0,1,838,838,0.42857
480,0,1,1,1,478,478,0.57143
240,0,1,1,1,210,210,0.57143
480,-31,0,0,1,462,493,0.42857
840,0,1,1,1,859,859,0.57143
0,0,1,1,2,-9,-9,0.71429
480,0,1,1,1,504,504,0.57143
0,0,1,1,2,-7,-7,0.71429
240,-30,0,0,2,240,270,0.28571
840,0,1,1,1,863,863,0.57143
240,0,1,1,1,223,223,0.57143
480,0,1,1,1,439,439,0.57143
480,0,1,1,1,456,456,0.57143
240,0,1,0,1,253,253,0.42857
0,0,1,1,3,-8,-8,0.85714
480,0,1,1,1,498,498,0.57143
0,36,0,0,3,-2,-38,0.14286
0,-63,0,0,4,-8,55,0
0,0,1,1,3,1,1,0.85714
0,0,1,1,3,-19,-19,0.85714
0,4,0,1,3,20,16,0.85714
840,15,0,1,1,850,835,0.57143
480,-14,0,1,1,477,491,0.57143
480,0,1,1,2,464,464,0.71429
480,0,1,1,1,439,439,0.57143
480,0,1,0,1,488,488,0.42857
840,0,1,0,1,824,824,0.42857
480,0,1,1,1,517,517,0.57143
480,0,1,1,1,449,449,0.57143
240,0,1,1,2,271,271,0.71429
240,48,0,0,3,271,223,0.14286
840,12,0,0,1,840,828,0.42857
0,0,1,1,3,-1,-1,0.85714
240,-42,0,0,3,224,266,0.14286
240,0,1,1,2,258,258,0.71429
240,-57,0,0,3,240,297,0.14286
480,-1,0,1,1,494,495,0.57143
480,-6,0,0,1,475,481,0.42857
840,0,1,1,1,836,836,0.57143
480,54,0,0,3,491,437,0.14286
480,-47,0,0,3,447,494,0.14286
480,-26,0,0,3,436,462,0.14286
840,89,0,0,4,876,787,0
480,-11,0,1,1,487,498,0.57143
240,0,1,1,1,209,209,0.57143
840,0,1,1,1,849,849,0.57143
0,18,0,0,2,4,-14,0.28571
480,30,0,0,2,490,460,0.28571
480,0,1,0,2,451,451,0.28571
0,-2,0,1,3,7,9,0.85714
480,0,1,1,1,509,509,0.57143
480,0,1,1,1,473,473,0.57143
840,0,1,1,1,884,884,0.57143
480,-11,0,1,1,469,480,0.57143
480,0,1,1,1,510,510,0.57143
0,-6,0,1,3,9,15,0.85714
0,16,0,0,3,26,10,0.14286
0,0,1,1,3,21,21,0.85714
240,0,1,1,1,219,219,0.57143
840,0,1,0,1,838,838,0.42857
840,-7,0,0,1,847,854,0.42857
0,0,1,1,3,20,20,0.85714
0,-32,0,0,3,-22,10,0.14286
0,-9,0,1,1,1,10,0.57143
480,14,0,0,1,476,462,0.42857
480,-49,0,0,3,441,490,0.14286
480,-16,0,0,2,490,506,0.28571
0,0,1,1,3,8,8,0.85714
840,0,1,1,1,845,845,0.57143
240,7,0,1,1,242,235,0.57143
0,-2,0,1,3,-9,-7,0.85714
240,-19,0,0,2,223,242,0.28571
480,0,1,1,1,520,520,0.57143
480,10,0,1,1,473,463,0.57143
240,3,0,1,2,245,242,0.71429
840,0,1,1,1,850,850,0.57143
0,41,0,0,3,33,-8,0.14286
840,-32,0,1,1,822,854,0.57143
480,0,1,1,1,492,492,0.57143
240,0,1,1,1,258,258,0.57143
0,0,1,1,3,-11,-11,0.85714
240,-4,0,1,1,234,238,0.57143
840,0,1,1,1,773,773,0.57143
0,22,0,0,3,11,-11,0.14286
240,2,0,1,1,255,253,0.57143
480,39,0,0,3,472,433,0.14286
480,-25,0,0,1,452,477,0.42857
240,0,1,1,1,205,205,0.57143
0,13,0,0,2,14,1,0.28571
240,2,0,1,1,266,264,0.57143
240,0,1,1,1,286,286,0.57143
0,-78,0,0,4,-42,36,0
240,0,1,0,1,227,227,0.42857
240,-14,0,0,2,211,225,0.28571
240,0,1,1,2,228,228,0.71429
0,-28,0,0,3,0,28,0.14286
840,0,1,1,1,850,850,0.57143
840,21,0,1,1,852,831,0.57143
480,0,1,0,1,477,477,0.42857
0,0,1,1,3,-11,-11,0.85714
240,2,0,1,1,235,233,0.57143
480,0,1,0,1,477,477,0.42857
0,0,1,1,3,2,2,0.85714
840,0,1,1,1,855,855,0.57143
480,-8,0,1,1,457,465,0.57143
240,-42,0,0,3,210,252,0.14286
0,0,1,1,1,40,40,0.57143
840,13,0,1,1,847,834,0.57143
840,0,1,1,1,860,860,0.57143
840,53,0,0,1,851,798,0.42857
240,3,0,1,2,226,223,0.71429
480,-36,0,0,2,474,510,0.28571
840,0,1,1,1,848,848,0.57143
0,0,1,1,3,25,25,0.85714
240,2,0,0,1,231,229,0.42857
240,-19,0,0,1,228,247,0.42857
480,0,1,1,1,489,489,0.57143
240,0,1,1,1,209,209,0.57143
240,-32,0,0,3,249,281,0.14286
480,0,1,1,1,503,503,0.57143
0,47,0,0,3,46,-1,0.14286
480,-66,0,0,3,446,512,0.14286
0,32,0,0,3,24,-8,0.14286
840,0,1,0,1,878,878,0.42857
480,49,0,0,3,501,452,0.14286
240,0,1,1,1,235,235,0.57143
0,6,0,1,2,-18,-24,0.71429
240,16,0,0,2,238,222,0.28571
840,0,1,1,1,879,879,0.57143
240,-40,0,0,3,197,237,0.14286
240,0,1,1,1,242,242,0.57143
840,-25,0,0,2,812,837,0.28571
240,10,0,1,1,241,231,0.57143
240,0,1,1,1,224,224,0.57143
0,13,0,1,2,41,28,0.71429
480,-41,0,0,1,467,508,0.42857
0,0,1,1,2,-17,-17,0.71429
480,0,1,1,1,531,531,0.57143
840,13,0,1,1,854,841,0.57143
0,-23,0,0,3,-15,8,0.14286
0,37,0,0,3,43,6,0.14286
480,67,0,0,3,531,464,0.14286
0,45,0,0,4,17,-28,0
0,0,1,0,1,8,8,0.42857
0,33,0,0,3,34,1,0.14286
0,21,0,0,2,-7,-28,0.28571
240,12,0,0,2,253,241,0.28571
840,0,1,1,1,782,782,0.57143
240,-4,0,0,1,228,232,0.42857
0,0,1,1,1,-14,-14,0.57143
0,0,1,1,1,-12,-12,0.57143
840,0,1,1,1,871,871,0.57143
240,41,0,0,2,262,221,0.28571
480,-33,0,1,1,486,519,0.57143
0,59,0,0,3,38,-21,0.14286
240,16,0,0,3,236,220,0.14286
480,-25,0,0,1,476,501,0.42857
480,0,1,0,1,488,488,0.42857
0,0,1,1,3,1,1,0.85714
480,0,1,1,1,480,480,0.57143
0,0,1,0,1,24,24,0.42857
240,0,1,1,2,210,210,0.71429
240,0,1,1,3,209,209,0.85714
840,0,1,1,1,842,842,0.57143
240,45,0,0,3,285,240,0.14286
0,27,0,0,3,-7,-34,0.14286
240,0,1,1,1,235,235,0.57143
0,-2,0,1,2,-3,-1,0.71429
840,0,1,1,1,841,841,0.57143
0,0,1,1,2,-20,-20,0.71429
480,0,1,1,1,458,458,0.57143
240,0,1,1,1,195,195,0.57143
480,0,1,1,1,470,470,0.57143
480,0,1,1,1,462,462,0.57143
0,0,1,1,2,-17,-17,0.71429
240,0,1,1,3,230,230,0.85714
240,0,1,1,2,254,254,0.71429
0,0,1,1,3,8,8,0.85714
840,-9,0,1,1,845,854,0.57143
240,67,0,0,3,266,199,0.14286
0,-34,0,0,3,-15,19,0.14286
0,0,1,1,1,-43,-43,0.57143
840,0,1,1,1,873,873,0.57143
0,-51,0,0,4,-21,30,0
0,0,1,1,3,16,16,0.85714
840,-59,0,1,1,788,847,0.57143
480,0,1,1,1,460,460,0.57143
0,41,0,0,3,13,-28,0.14286
480,-5,0,1,1,500,505,0.57143
240,-1,0,1,1,208,209,0.57143
0,0,1,1,3,45,45,0.85714
480,0,1,1,1,440,440,0.57143
240,32,0,0,3,254,222,0.14286
480,0,1,1,1,514,514,0.57143
0,-2,0,1,3,-18,-16,0.85714
240,38,0,0,1,243,205,0.42857
840,0,1,0,1,914,914,0.42857
240,20,0,1,1,232,212,0.57143
480,0,1,1,1,493,493,0.57143
480,26,0,0,2,511,485,0.28571
840,0,1,1,1,872,872,0.57143
840,5,0,0,1,819,814,0.42857
840,24,0,1,1,857,833,0.57143
480,-27,0,1,1,463,490,0.57143
240,-23,0,0,1,257,280,0.42857
840,-7,0,1,1,846,853,0.57143
480,0,1,1,2,482,482,0.71429
480,-5,0,1,1,486,491,0.57143
240,0,1,1,1,267,267,0.57143
840,4,0,1,1,857,853,0.57143
840,116,0,0,3,896,780,0.14286
480,0,1,1,1,484,484,0.57143
480,-24,0,0,1,435,459,0.42857
240,0,1,1,1,206,206,0.57143
240,-3,0,1,2,239,242,0.71429
240,12,0,1,2,242,230,0.71429
240,10,0,0,1,261,251,0.42857
840,0,1,1,1,853,853,0.57143
0,0,1,1,2,23,23,0.71429
480,0,1,1,2,523,523,0.71429
0,0,1,1,3,-19,-19,0.85714
480,0,1,1,1,493,493,0.57143
240,0,1,1,1,287,287,0.57143
0,33,0,0,3,17,-16,0.14286
0,-14,0,0,3,-41,-27,0.14286
840,0,1,0,1,812,812,0.42857
840,0,1,1,1,832,832,0.57143
840,-15,0,1,1,839,854,0.57143
240,0,1,0,1,235,235,0.42857
480,9,0,1,1,438,429,0.57143
0,0,1,0,1,14,14,0.42857
0,0,1,1,3,13,13,0.85714
840,12,0,1,1,845,833,0.57143
240,95,0,0,4,276,181,0
840,0,1,0,1,858,858,0.42857
840,0,1,1,1,873,873,0.57143
840,0,1,1,1,847,847,0.57143
480,-76,0,0,3,438,514,0.14286
480,-17,0,0,2,491,508,0.28571
480,0,1,1,1,492,492,0.57143
840,0,1,1,1,843,843,0.57143
480,0,1,0,1,511,511,0.42857
240,-17,0,0,1,240,257,0.42857
840,-24,0,0,1,784,808,0.42857
0,73,0,0,4,36,-37,0
0,0,1,1,2,13,13,0.71429
840,43,0,0,1,843,800,0.42857
240,0,1,1,2,223,223,0.71429
0,36,0,0,2,40,4,0.28571
240,0,1,1,1,207,207,0.57143
840,-26,0,0,1,826,852,0.42857
240,0,1,0,1,239,239,0.42857
240,0,1,1,1,255,255,0.57143
240,54,0,0,3,294,240,0.14286
840,23,0,1,1,850,827,0.57143
240,0,1,1,2,251,251,0.71429
240,10,0,1,1,244,234,0.57143
0,-12,0,0,1,30,42,0.42857
480,-19,0,0,1,502,521,0.42857
0,0,1,1,3,6,6,0.85714
480,0,1,1,1,454,454,0.57143
240,-13,0,0,1,243,256,0.42857
0,0,1,1,2,-8,-8,0.71429
480,0,1,0,1,503,503,0.42857
840,0,1,0,1,809,809,0.42857
480,0,1,0,1,495,495,0.42857
0,30,0,0,3,-8,-38,0.14286
0,0,1,1,2,-9,-9,0.71429
480,-7,0,1,1,489,496,0.57143
480,0,1,1,1,462,462,0.57143
840,0,1,1,1,815,815,0.57143
480,-19,0,0,2,470,489,0.28571
480,0,1,1,1,462,462,0.57143
840,-30,0,0,1,820,850,0.42857
240,0,1,1,2,207,207,0.71429
0,0,1,1,3,8,8,0.85714
840,0,1,1,1,850,850,0.57143
0,0,1,1,3,0,0,0.85714
480,0,1,1,1,477,477,0.57143
240,34,0,0,1,270,236,0.42857
240,0,1,1,1,199,199,0.57143
480,0,1,1,2,490,490,0.71429
240,58,0,0,3,270,212,0.14286
840,29,0,0,1,854,825,0.42857
0,14,0,0,2,-3,-17,0.28571
480,-29,0,0,2,466,495,0.28571
840,0,1,1,1,834,834,0.57143
480,-11,0,0,1,456,467,0.42857
480,0,1,1,1,531,531,0.57143
480,-42,0,0,2,461,503,0.28571
840,0,1,0,1,869,869,0.42857
0,24,0,0,3,9,-15,0.14286
840,0,1,1,1,856,856,0.57143
840,0,1,1,1,879,879,0.57143
0,-1,0,1,2,29,30,0.71429
840,0,1,1,1,867,867,0.57143
240,21,0,0,2,260,239,0.28571
840,0,1,0,1,830,830,0.42857
480,24,0,0,1,458,434,0.42857
840,0,1,1,1,853,853,0.57143
240,0,1,0,2,300,300,0.28571
0,0,1,1,2,21,21,0.71429
240,-58,0,0,3,187,245,0.14286
0,0,1,1,2,-13,-13,0.71429
480,48,0,0,3,510,462,0.14286
0,24,0,0,3,9,-15,0.14286
480,0,1,1,1,486,486,0.57143
0,0,1,1,2,5,5,0.71429
840,-13,0,0,1,849,862,0.42857
480,82,0,0,3,536,454,0.14286
840,-71,0,0,2,819,890,0.28571
840,39,0,0,2,893,854,0.28571
240,-7,0,0,2,234,241,0.28571
840,0,1,0,2,817,817,0.28571
840,23,0,0,2,860,837,0.28571
0,0,1,1,3,-27,-27,0.85714
840,0,1,1,1,822,822,0.57143
0,24,0,0,2,-1,-25,0.28571
840,0,1,0,1,802,802,0.42857
480,0,1,1,1,525,525,0.57143
0,26,0,1,3,15,-11,0.85714
0,0,1,1,3,16,16,0.85714
240,0,1,1,1,245,245,0.57143
840,-46,0,0,1,839,885,0.42857
840,0,1,0,1,828,828,0.42857
840,-10,0,1,1,833,843,0.57143
840,0,1,0,1,860,860,0.42857
0,-50,0,0,3,-33,17,0.14286
0,59,0,0,3,10,-49,0.14286
0,13,0,0,2,10,-3,0.28571
480,-49,0,0,2,463,512,0.28571
480,28,0,0,2,500,472,0.28571
480,36,0,0,2,498,462,0.28571
840,27,0,0,2,842,815,0.28571
840,0,1,0,1,809,809,0.42857
840,39,0,1,1,845,806,0.57143
240,8,0,0,1,278,270,0.42857
840,48,0,1,1,891,843,0.57143
840,-2,0,1,1,819,821,0.57143
240,0,1,1,2,216,216,0.71429
480,0,1,1,1,518,518,0.57143
840,12,0,1,1,851,839,0.57143
240,0,1,1,1,262,262,0.57143
480,67,0,0,3,525,458,0.14286
480,26,0,0,2,483,457,0.28571
240,0,1,0,1,239,239,0.42857
480,-74,0,0,3,447,521,0.14286
0,0,1,1,1,40,40,0.57143
480,0,1,1,1,452,452,0.57143
0,0,1,1,3,-7,-7,0.85714
240,0,1,1,3,255,255,0.85714
0,0,1,1,3,-10,-10,0.85714
480,0,1,1,3,500,500,0.85714
0,0,1,1,2,45,45,0.71429
480,0,1,1,1,463,463,0.57143
0,0,1,1,1,25,25,0.57143
240,38,0,0,2,227,189,0.28571
240,0,1,1,1,234,234,0.57143
840,-5,0,1,1,858,863,0.57143
240,-42,0,0,3,225,267,0.14286
840,-5,0,0,2,825,830,0.28571
0,-5,0,0,1,9,14,0.42857
240,0,1,1,1,269,269,0.57143
240,0,1,0,1,227,227,0.42857
480,-33,0,0,1,459,492,0.42857
240,0,1,0,1,266,266,0.42857
240,-24,0,0,1,258,282,0.42857
0,0,1,1,1,-25,-25,0.57143
840,-5,0,1,1,835,840,0.57143
840,31,0,0,1,843,812,0.42857
840,0,1,0,1,864,864,0.42857
840,-29,0,0,1,814,843,0.42857
840,0,1,0,1,813,813,0.42857
480,0,1,1,1,460,460,0.57143
0,0,1,1,2,-35,-35,0.71429
0,0,1,1,2,39,39,0.71429
840,-38,0,0,2,809,847,0.28571
480,2,0,1,1,471,469,0.57143
840,-12,0,0,1,842,854,0.42857
240,65,0,0,3,267,202,0.14286
840,-1,0,1,1,826,827,0.57143
240,0,1,1,1,235,235,0.57143
0,14,0,0,2,5,-9,0.28571
840,0,1,1,1,868,868,0.57143
480,0,1,1,1,518,518,0.57143
240,0,1,0,2,229,229,0.28571
240,-16,0,0,2,226,242,0.28571
840,0,1,1,1,861,861,0.57143
840,0,1,1,1,857,857,0.57143
240,-10,0,0,2,247,257,0.28571
480,-3,0,0,2,485,488,0.28571
840,0,1,1,1,805,805,0.57143
240,0,1,1,1,257,257,0.57143
0,-8,0,0,1,-8,-0,0.42857
480,25,0,0,2,490,465,0.28571
0,0,1,1,1,26,26,0.57143
0,16,0,1,1,-8,-24,0.57143
0,0,1,1,3,29,29,0.85714
240,39,0,0,2,285,246,0.28571
840,-16,0,0,1,792,808,0.42857
240,0,1,1,1,216,216,0.57143
0,-7,0,0,1,24,31,0.42857
480,48,0,0,3,471,423,0.14286
0,0,1,1,2,7,7,0.71429
840,0,1,1,1,857,857,0.57143
480,0,1,0,1,470,470,0.42857
480,0,1,0,1,502,502,0.42857
240,0,1,0,1,214,214,0.42857
0,-49,0,0,4,-27,22,0
240,45,0,0,3,253,208,0.14286
240,0,1,0,2,204,204,0.28571
0,-16,0,0,2,10,26,0.28571
0,6,0,1,2,-47,-53,0.71429
240,-30,0,0,3,215,245,0.14286
840,0,1,1,1,857,857,0.57143
0,24,0,0,2,-21,-45,0.28571
480,73,0,0,4,501,428,0
0,0,1,1,1,-1,-1,0.57143
480,0,1,1,1,516,516,0.57143
0,0,1,1,2,50,50,0.71429
480,4,0,0,1,494,490,0.42857
480,37,0,0,4,519,482,0
0,0,1,1,2,-1,-1,0.71429
480,0,1,0,2,496,496,0.28571
0,4,0,1,2,-1,-5,0.71429
0,-29,0,0,3,-10,19,0.14286
480,27,0,0,2,490,463,0.28571
840,-14,0,0,1,832,846,0.42857
0,-4,0,0,1,29,33,0.42857
480,0,1,0,1,482,482,0.42857
840,0,1,1,1,831,831,0.57143
240,0,1,0,1,228,228,0.42857
0,-29,0,0,3,-19,10,0.14286
840,0,1,1,1,850,850,0.57143
0,0,1,1,2,23,23,0.71429
240,0,1,1,1,244,244,0.57143
840,-42,0,1,1,813,855,0.57143
840,-21,0,1,1,846,867,0.57143
480,0,1,0,1,466,466,0.42857
240,38,0,0,2,256,218,0.28571
240,0,1,1,1,220,220,0.57143
240,-9,0,0,1,205,214,0.42857
0,-24,0,0,2,-21,3,0.28571
480,0,1,0,1,432,432,0.42857
480,-24,0,0,1,472,496,0.42857
240,0,1,0,1,259,259,0.42857
480,0,1,1,1,472,472,0.57143
480,-4,0,0,1,462,466,0.42857
0,0,1,1,1,16,16,0.57143
840,2,0,1,1,833,831,0.57143
840,0,1,1,1,839,839,0.57143
840,7,0,1,1,833,826,0.57143
480,0,1,0,1,485,485,0.42857
0,0,1,1,1,-27,-27,0.57143
840,-44,0,0,2,812,856,0.28571
240,-18,0,0,2,256,274,0.28571
0,-21,0,0,2,-59,-38,0.28571
240,0,1,1,1,269,269,0.57143
240,-24,0,0,2,245,269,0.28571
240,43,0,0,2,233,190,0.28571
480,0,1,1,1,514,514,0.57143
240,11,0,0,2,228,217,0.28571
0,0,1,1,2,-1,-1,0.71429
480,-9,0,0,1,476,485,0.42857
0,0,1,1,1,24,24,0.57143
480,-12,0,0,1,474,486,0.42857
840,0,1,0,1,840,840,0.42857
240,0,1,1,1,229,229,0.57143
0,-13,0,0,2,-11,2,0.28571
0,-34,0,0,3,-9,25,0.14286
480,-18,0,0,1,492,510,0.42857
0,50,0,0,3,49,-1,0.14286
0,0,1,1,1,-8,-8,0.57143
240,0,1,1,1,267,267,0.57143
240,0,1,0,1,256,256,0.42857
840,0,1,1,1,867,867,0.57143
480,48,0,0,2,526,478,0.28571
840,0,1,0,2,843,843,0.28571
480,-49,0,0,1,431,480,0.42857
0,61,0,0,3,37,-24,0.14286
0,0,1,1,1,7,7,0.57143
480,-42,0,0,2,474,516,0.28571
480,-6,0,1,1,470,476,0.57143
240,40,0,0,3,255,215,0.14286
0,0,1,1,1,33,33,0.57143
840,5,0,1,1,861,856,0.57143
480,0,1,1,1,509,509,0.57143
