0,0,1,0,3,-25,-25,0.14286
0,0,1,0,3,-6,-6,0.14286
0,0,1,0,3,-0,-0,0.14286
240,0,1,0,2,245,245,0.28571
480,20,0,1,2,478,458,0.71429
0,-17,0,0,3,14,31,0.14286
240,0,1,1,2,209,209,0.71429
240,0,1,1,1,213,213,0.57143
0,-68,0,0,4,-31,37,0
0,-6,0,0,4,-14,-8,0
840,0,1,1,1,874,874,0.57143
0,46,0,0,4,14,-32,0
0,0,1,1,2,-27,-27,0.71429
840,0,1,1,2,860,860,0.71429
240,-13,0,1,2,246,259,0.71429
240,0,1,1,1,291,291,0.57143
0,-14,0,0,2,3,17,0.28571
840,0,1,1,1,834,834,0.57143
480,0,1,0,1,476,476,0.42857
840,53,0,0,1,860,807,0.42857
840,0,1,0,2,861,861,0.28571
840,0,1,0,3,850,850,0.14286
0,0,1,1,1,-27,-27,0.57143
0,-12,0,0,3,-25,-13,0.14286
0,0,1,0,2,5,5,0.28571
480,54,0,0,2,518,464,0.28571
240,5,0,0,3,242,237,0.14286
480,0,1,1,2,515,515,0.71429
240,43,0,1,3,255,212,0.85714
0,0,1,1,2,-35,-35,0.71429
480,47,0,0,1,502,455,0.42857
0,39,0,0,3,18,-21,0.14286
240,0,1,0,2,279,279,0.28571
480,13,0,0,2,473,460,0.28571
840,0,1,0,1,846,846,0.42857
0,0,1,0,1,20,20,0.42857
480,0,1,1,1,522,522,0.57143
480,0,1,1,1,510,510,0.57143
840,0,1,1,1,807,807,0.57143
840,0,1,1,1,817,817,0.57143
240,0,1,1,1,270,270,0.57143
840,31,0,1,1,839,808,0.57143
840,0,1,1,2,854,854,0.71429
240,0,1,1,2,248,248,0.71429
480,0,1,1,3,475,475,0.85714
840,0,1,1,1,834,834,0.57143
480,0,1,1,1,491,491,0.57143
480,-16,0,1,1,486,502,0.57143
840,28,0,0,2,856,828,0.28571
480,21,0,1,1,494,473,0.57143
480,3,0,1,1,474,471,0.57143
0,0,1,1,1,36,36,0.57143
480,0,1,1,2,504,504,0.71429
480,0,1,1,1,465,465,0.57143
0,0,1,1,1,-33,-33,0.57143
240,0,1,1,1,232,232,0.57143
240,28,0,1,2,246,218,0.71429
480,-17,0,1,2,479,496,0.71429
840,0,1,1,2,831,831,0.71429
480,20,0,1,2,473,453,0.71429
480,0,1,1,1,438,438,0.57143
0,0,1,1,1,1,1,0.57143
840,0,1,0,1,817,817,0.42857
0,-27,0,0,4,-17,10,0
480,-18,0,0,2,469,487,0.28571
240,9,0,1,1,239,230,0.57143
240,0,1,0,2,230,230,0.28571
240,-4,0,0,2,246,250,0.28571
240,0,1,0,1,214,214,0.42857
240,0,1,1,1,265,265,0.57143
240,0,1,1,1,246,246,0.57143
0,0,1,1,1,22,22,0.57143
480,22,0,1,1,505,483,0.57143
480,0,1,1,2,467,467,0.71429
0,8,0,0,3,16,8,0.14286
480,0,1,0,1,493,493,0.42857
0,43,0,0,3,24,-19,0.14286
0,-37,0,0,3,-16,21,0.14286
0,14,0,0,3,9,-5,0.14286
840,1,0,1,2,852,851,0.71429
0,0,1,1,3,-28,-28,0.85714
240,0,1,1,3,225,225,0.85714
480,39,0,1,3,492,453,0.85714
0,0,1,1,3,44,44,0.85714
0,0,1,1,3,20,20,0.85714
240,0,1,1,4,291,291,1
240,0,1,0,2,218,218,0.28571
840,-29,0,1,3,825,854,0.85714
840,-59,0,0,3,810,869,0.14286
240,0,1,1,1,218,218,0.57143
240,-28,0,0,2,206,234,0.28571
0,0,1,0,1,21,21,0.42857
840,0,1,0,1,824,824,0.42857
0,-5,0,1,1,6,11,0.57143
240,1,0,1,1,258,257,0.57143
0,0,1,1,1,-5,-5,0.57143
0,0,1,0,2,10,10,0.28571
0,21,0,0,3,26,5,0.14286
0,0,1,0,3,5,5,0.14286
840,0,1,1,1,874,874,0.57143
240,23,0,1,1,223,200,0.57143
0,0,1,0,1,10,10,0.42857
480,0,1,1,1,503,503,0.57143
0,0,1,1,1,-19,-19,0.57143
0,0,1,1,1,12,12,0.57143
480,-41,0,0,1,471,512,0.42857
840,0,1,1,1,849,849,0.57143
240,0,1,1,1,211,211,0.57143
0,0,1,0,2,28,28,0.28571
480,0,1,1,1,468,468,0.57143
480,0,1,1,1,502,502,0.57143
240,0,1,1,2,228,228,0.71429
480,0,1,0,1,470,470,0.42857
240,0,1,1,1,222,222,0.57143
240,0,1,1,2,269,269,0.71429
840,0,1,1,1,861,861,0.57143
480,-4,0,1,1,506,510,0.57143
240,0,1,0,2,202,202,0.28571
0,-3,0,0,3,-14,-11,0.14286
480,32,0,0,2,509,477,0.28571
840,-13,0,1,3,829,842,0.85714
840,-28,0,1,2,842,870,0.71429
0,10,0,0,3,-25,-35,0.14286
840,-32,0,0,2,824,856,0.28571
840,0,1,0,2,842,842,0.28571
840,0,1,0,1,845,845,0.42857
840,-36,0,0,1,766,802,0.42857
240,-25,0,1,1,224,249,0.57143
0,0,1,0,2,58,58,0.28571
480,28,0,0,3,476,448,0.14286
0,0,1,0,4,0,0,0
240,22,0,0,4,244,222,0
480,21,0,0,3,474,453,0.14286
480,0,1,0,3,475,475,0.14286
840,3,0,0,3,833,830,0.14286
480,0,1,0,3,456,456,0.14286
840,0,1,0,3,828,828,0.14286
0,0,1,0,4,5,5,0
240,3,0,0,4,244,241,0
240,0,1,0,4,206,206,0
0,0,1,1,1,-10,-10,0.57143
240,0,1,1,2,254,254,0.71429
0,-51,0,0,3,-13,38,0.14286
840,-37,0,0,3,802,839,0.14286
480,-40,0,0,3,433,473,0.14286
480,0,1,0,3,502,502,0.14286
0,0,1,0,3,31,31,0.14286
0,0,1,0,3,37,37,0.14286
240,0,1,0,2,211,211,0.28571
840,10,0,0,3,845,835,0.14286
840,-4,0,0,4,833,837,0
840,-24,0,1,3,844,868,0.85714
840,43,0,0,4,889,846,0
480,31,0,0,2,486,455,0.28571
840,0,1,0,3,853,853,0.14286
840,0,1,0,3,850,850,0.14286
0,-67,0,0,4,-38,29,0
240,22,0,0,2,218,196,0.28571
480,24,0,0,3,475,451,0.14286
0,9,0,1,3,36,27,0.85714
0,0,1,0,2,-6,-6,0.28571
480,16,0,1,3,484,468,0.85714
480,0,1,1,3,473,473,0.85714
480,28,0,0,3,524,496,0.14286
240,0,1,0,3,243,243,0.14286
240,-31,0,0,2,234,265,0.28571
840,0,1,0,1,845,845,0.42857
0,31,0,0,3,30,-1,0.14286
480,-56,0,0,3,449,505,0.14286
240,0,1,0,2,248,248,0.28571
0,0,1,1,1,30,30,0.57143
840,0,1,1,1,851,851,0.57143
480,-28,0,1,1,492,520,0.57143
0,0,1,0,2,-7,-7,0.28571
240,-20,0,0,2,220,240,0.28571
0,-4,0,0,3,-11,-7,0.14286
840,0,1,0,2,836,836,0.28571
240,0,1,1,1,207,207,0.57143
840,56,0,0,2,862,806,0.28571
480,-42,0,1,3,460,502,0.85714
240,-22,0,0,3,214,236,0.14286
840,0,1,1,3,839,839,0.85714
0,0,1,0,4,1,1,0
240,6,0,1,2,262,256,0.71429
840,0,1,1,2,852,852,0.71429
240,0,1,1,2,282,282,0.71429
840,0,1,1,2,873,873,0.71429
840,-25,0,1,2,838,863,0.71429
840,0,1,1,3,841,841,0.85714
480,-29,0,1,2,483,512,0.71429
240,0,1,0,3,237,237,0.14286
480,24,0,1,2,480,456,0.71429
240,0,1,1,2,231,231,0.71429
240,17,0,0,1,261,244,0.42857
480,-14,0,1,2,483,497,0.71429
840,-52,0,1,1,812,864,0.57143
480,0,1,1,2,491,491,0.71429
240,0,1,1,3,268,268,0.85714
0,11,0,1,1,8,-3,0.57143
840,-66,0,1,1,817,883,0.57143
0,-39,0,0,3,-6,33,0.14286
0,0,1,1,1,28,28,0.57143
240,-1,0,0,2,243,244,0.28571
480,11,0,0,2,496,485,0.28571
480,0,1,1,1,492,492,0.57143
840,-25,0,0,2,818,843,0.28571
480,20,0,0,2,476,456,0.28571
0,-36,0,0,3,-17,19,0.14286
0,-48,0,0,3,-50,-2,0.14286
840,0,1,1,1,844,844,0.57143
240,-9,0,0,2,228,237,0.28571
240,0,1,0,2,258,258,0.28571
240,0,1,0,2,193,193,0.28571
240,0,1,0,3,249,249,0.14286
240,0,1,0,2,205,205,0.28571
240,49,0,0,2,278,229,0.28571
480,0,1,1,1,480,480,0.57143
480,3,0,0,3,480,477,0.14286
840,0,1,0,3,838,838,0.14286
240,20,0,0,2,231,211,0.28571
840,0,1,0,2,800,800,0.28571
0,0,1,0,2,54,54,0.28571
240,0,1,0,2,284,284,0.28571
0,6,0,0,4,-5,-11,0
480,0,1,1,2,503,503,0.71429
480,0,1,1,2,482,482,0.71429
240,0,1,1,3,223,223,0.85714
840,0,1,1,4,837,837,1
240,0,1,0,1,253,253,0.42857
0,42,0,1,1,6,-36,0.57143
480,13,0,1,2,493,480,0.71429
240,0,1,1,1,269,269,0.57143
240,0,1,1,1,232,232,0.57143
0,-35,0,0,4,-31,4,0
840,0,1,1,3,828,828,0.85714
840,-11,0,1,2,861,872,0.71429
240,-10,0,1,2,247,257,0.71429
480,-1,0,1,2,469,470,0.71429
240,0,1,1,2,225,225,0.71429
840,20,0,1,3,851,831,0.85714
480,-43,0,0,3,456,499,0.14286
840,-25,0,1,2,833,858,0.71429
0,19,0,0,4,-12,-31,0
480,18,0,0,3,489,471,0.14286
240,0,1,0,2,234,234,0.28571
480,0,1,1,2,474,474,0.71429
0,0,1,0,2,63,63,0.28571
240,-34,0,0,3,226,260,0.14286
480,40,0,0,3,475,435,0.14286
480,-16,0,0,3,462,478,0.14286
840,0,1,0,3,824,824,0.14286
480,30,0,0,2,503,473,0.28571
0,0,1,0,2,-59,-59,0.28571
480,-37,0,0,3,469,506,0.14286
840,28,0,0,3,866,838,0.14286
0,0,1,0,3,36,36,0.14286
480,0,1,0,2,462,462,0.28571
840,3,0,0,3,840,837,0.14286
480,36,0,0,2,508,472,0.28571
0,0,1,0,2,-5,-5,0.28571
240,0,1,0,2,215,215,0.28571
240,-21,0,0,3,200,221,0.14286
480,0,1,1,2,498,498,0.71429
240,0,1,1,2,253,253,0.71429
840,13,0,1,2,844,831,0.71429
0,-8,0,0,3,15,23,0.14286
0,45,0,0,4,7,-38,0
840,7,0,0,3,850,843,0.14286
240,0,1,0,2,216,216,0.28571
0,0,1,1,2,-3,-3,0.71429
0,-19,0,0,3,-7,12,0.14286
240,18,0,1,2,226,208,0.71429
480,0,1,1,3,500,500,0.85714
0,0,1,1,3,-12,-12,0.85714
240,-10,0,1,2,211,221,0.71429
240,-59,0,0,3,232,291,0.14286
240,0,1,1,3,230,230,0.85714
480,-27,0,1,2,469,496,0.71429
240,0,1,1,2,203,203,0.71429
840,2,0,1,3,841,839,0.85714
840,47,0,0,3,898,851,0.14286
840,-14,0,1,2,849,863,0.71429
0,0,1,1,3,-4,-4,0.85714
480,0,1,1,4,480,480,1
480,-70,0,0,4,420,490,0
0,23,0,0,3,39,16,0.14286
480,-49,0,0,3,455,504,0.14286
840,0,1,1,3,835,835,0.85714
480,-39,0,1,2,470,509,0.71429
480,-16,0,1,2,476,492,0.71429
480,-30,0,0,3,466,496,0.14286
0,-32,0,0,3,-23,9,0.14286
840,0,1,1,2,816,816,0.71429
0,0,1,1,4,-47,-47,1
0,0,1,1,3,-22,-22,0.85714
240,24,0,1,2,265,241,0.71429
240,0,1,1,3,220,220,0.85714
0,-64,0,0,3,-17,47,0.14286
840,0,1,0,2,853,853,0.28571
480,0,1,0,2,474,474,0.28571
840,-46,0,0,1,863,909,0.42857
240,11,0,1,1,225,214,0.57143
0,-8,0,1,1,12,20,0.57143
240,57,0,0,3,275,218,0.14286
0,-22,0,0,2,-20,2,0.28571
840,15,0,1,2,811,796,0.71429
840,0,1,1,1,854,854,0.57143
840,0,1,1,1,849,849,0.57143
480,0,1,1,3,544,544,0.85714
840,0,1,1,3,840,840,0.85714
240,0,1,1,3,220,220,0.85714
840,0,1,1,3,861,861,0.85714
0,-15,0,0,2,-17,-2,0.28571
240,13,0,1,2,254,241,0.71429
0,-20,0,1,2,3,23,0.71429
840,-3,0,1,2,854,857,0.71429
240,0,1,1,2,272,272,0.71429
0,0,1,1,3,56,56,0.85714
480,-40,0,1,3,471,511,0.85714
0,11,0,0,2,12,1,0.28571
840,0,1,0,3,871,871,0.14286
480,0,1,1,2,501,501,0.71429
240,0,1,1,2,270,270,0.71429
240,-18,0,1,3,228,246,0.85714
480,10,0,1,2,519,509,0.71429
0,0,1,1,2,-17,-17,0.71429
840,0,1,1,2,791,791,0.71429
840,0,1,1,2,878,878,0.71429
840,-4,0,1,2,835,839,0.71429
0,-26,0,0,2,-18,8,0.28571
480,16,0,1,2,537,521,0.71429
480,0,1,0,2,488,488,0.28571
480,15,0,1,3,502,487,0.85714
840,0,1,0,2,814,814,0.28571
240,-22,0,1,3,234,256,0.85714
0,0,1,1,2,46,46,0.71429
240,0,1,1,1,237,237,0.57143
240,0,1,1,2,227,227,0.71429
240,-28,0,0,2,210,238,0.28571
240,0,1,0,2,259,259,0.28571
840,-22,0,0,2,843,865,0.28571
0,-28,0,0,3,-19,9,0.14286
240,3,0,1,2,246,243,0.71429
240,3,0,1,2,265,262,0.71429
840,-28,0,1,2,788,816,0.71429
240,13,0,1,2,253,240,0.71429
480,0,1,1,3,489,489,0.85714
840,-28,0,1,2,822,850,0.71429
480,0,1,1,3,431,431,0.85714
0,1,0,1,3,-9,-10,0.85714
0,17,0,0,2,13,-4,0.28571
480,0,1,0,2,465,465,0.28571
480,0,1,1,1,485,485,0.57143
840,-17,0,0,2,834,851,0.28571
480,0,1,1,2,502,502,0.71429
0,7,0,0,3,18,11,0.14286
480,72,0,0,3,513,441,0.14286
840,35,0,0,3,877,842,0.14286
480,0,1,0,2,506,506,0.28571
240,-25,0,0,2,230,255,0.28571
480,44,0,0,2,484,440,0.28571
240,51,0,0,3,269,218,0.14286
0,-34,0,0,3,-8,26,0.14286
840,0,1,0,2,829,829,0.28571
240,0,1,1,2,243,243,0.71429
0,0,1,1,3,3,3,0.85714
240,-16,0,1,3,257,273,0.85714
480,0,1,1,2,472,472,0.71429
0,13,0,0,2,33,20,0.28571
0,0,1,1,2,3,3,0.71429
480,0,1,1,2,471,471,0.71429
840,-14,0,0,2,825,839,0.28571
240,-57,0,0,2,208,265,0.28571
240,-26,0,0,3,212,238,0.14286
840,17,0,0,3,864,847,0.14286
240,0,1,0,2,230,230,0.28571
840,0,1,0,2,858,858,0.28571
240,0,1,0,3,281,281,0.14286
240,0,1,0,2,247,247,0.28571
480,0,1,0,2,522,522,0.28571
480,-15,0,0,2,469,484,0.28571
480,-11,0,0,2,478,489,0.28571
240,0,1,1,2,222,222,0.71429
240,-20,0,1,2,216,236,0.71429
840,36,0,0,3,848,812,0.14286
240,0,1,1,2,264,264,0.71429
480,-17,0,1,2,466,483,0.71429
0,0,1,1,2,-77,-77,0.71429
480,43,0,0,3,495,452,0.14286
0,-43,0,0,3,-27,16,0.14286
0,-13,0,1,2,-21,-8,0.71429
840,0,1,1,2,871,871,0.71429
0,0,1,1,3,-4,-4,0.85714
480,26,0,1,2,507,481,0.71429
240,0,1,1,2,218,218,0.71429
240,0,1,1,2,251,251,0.71429
0,14,0,1,2,3,-11,0.71429
0,-15,0,0,3,30,45,0.14286
0,-27,0,0,3,-7,20,0.14286
0,0,1,1,3,27,27,0.85714
840,-41,0,0,2,821,862,0.28571
480,0,1,1,2,478,478,0.71429
840,-4,0,1,2,849,853,0.71429
840,-41,0,1,3,814,855,0.85714
240,34,0,0,3,276,242,0.14286
0,0,1,1,3,-51,-51,0.85714
840,18,0,1,2,857,839,0.71429
0,0,1,1,2,0,0,0.71429
0,13,0,1,2,-2,-15,0.71429
840,0,1,1,2,877,877,0.71429
840,-28,0,1,3,835,863,0.85714
240,44,0,0,3,253,209,0.14286
0,0,1,1,3,-15,-15,0.85714
240,0,1,1,1,219,219,0.57143
0,0,1,0,3,9,9,0.14286
840,14,0,1,2,851,837,0.71429
840,0,1,1,3,834,834,0.85714
240,0,1,1,3,219,219,0.85714
0,0,1,1,3,39,39,0.85714
840,0,1,1,3,796,796,0.85714
240,-8,0,1,3,253,261,0.85714
840,0,1,1,3,872,872,0.85714
480,14,0,1,3,470,456,0.85714
480,0,1,1,3,487,487,0.85714
0,4,0,1,2,-15,-19,0.71429
840,0,1,1,2,857,857,0.71429
240,-52,0,0,3,238,290,0.14286
840,0,1,1,2,852,852,0.71429
840,14,0,1,2,840,826,0.71429
240,76,0,0,3,258,182,0.14286
0,-106,0,0,4,-49,57,0
240,0,1,1,2,236,236,0.71429
840,14,0,0,1,848,834,0.42857
240,2,0,1,2,246,244,0.71429
840,-17,0,1,3,842,859,0.85714
240,-34,0,1,2,242,276,0.71429
0,12,0,0,2,2,-10,0.28571
480,-5,0,0,2,472,477,0.28571
480,0,1,0,3,477,477,0.14286
240,0,1,0,2,256,256,0.28571
480,0,1,0,1,436,436,0.42857
480,19,0,0,1,505,486,0.42857
480,4,0,0,1,516,512,0.42857
240,-1,0,0,1,263,264,0.42857
480,0,1,0,1,489,489,0.42857
0,0,1,0,1,-9,-9,0.42857
240,14,0,0,2,210,196,0.28571
240,0,1,0,1,228,228,0.42857
0,29,0,0,1,13,-16,0.42857
480,23,0,1,2,492,469,0.71429
0,0,1,1,1,1,1,0.57143
840,-1,0,1,1,823,824,0.57143
0,-9,0,0,3,-31,-22,0.14286
480,0,1,1,2,504,504,0.71429
840,-20,0,1,2,823,843,0.71429
840,42,0,0,3,862,820,0.14286
840,0,1,0,2,840,840,0.28571
0,22,0,0,2,30,8,0.28571
840,0,1,1,2,845,845,0.71429
240,0,1,1,2,231,231,0.71429
480,0,1,1,2,475,475,0.71429
840,-52,0,1,3,810,862,0.85714
840,0,1,1,2,865,865,0.71429
840,18,0,1,2,834,816,0.71429
0,66,0,0,3,27,-39,0.14286
240,8,0,1,2,244,236,0.71429
480,-20,0,0,1,466,486,0.42857
0,37,0,0,2,12,-25,0.28571
840,49,0,0,1,838,789,0.42857
480,0,1,1,2,455,455,0.71429
840,0,1,1,2,852,852,0.71429
0,-7,0,0,3,-11,-4,0.14286
240,0,1,1,2,187,187,0.71429
480,0,1,1,2,518,518,0.71429
840,0,1,1,2,817,817,0.71429
0,0,1,1,3,-35,-35,0.85714
0,0,1,1,2,1,1,0.71429
240,0,1,1,2,246,246,0.71429
480,0,1,1,2,443,443,0.71429
240,-18,0,1,2,247,265,0.71429
480,0,1,1,3,492,492,0.85714
840,0,1,1,3,842,842,0.85714
480,-53,0,0,3,452,505,0.14286
840,1,0,1,2,823,822,0.71429
480,0,1,1,2,452,452,0.71429
480,0,1,1,1,434,434,0.57143
480,0,1,1,1,498,498,0.57143
840,-5,0,1,1,841,846,0.57143
0,0,1,1,1,3,3,0.57143
480,0,1,1,2,454,454,0.71429
840,-6,0,1,3,832,838,0.85714
240,-1,0,1,2,244,245,0.71429
240,0,1,1,2,267,267,0.71429
480,5,0,1,1,503,498,0.57143
480,0,1,1,1,450,450,0.57143
0,31,0,0,3,25,-6,0.14286
240,0,1,1,1,259,259,0.57143
240,0,1,1,2,271,271,0.71429
840,-35,0,1,2,804,839,0.71429
840,0,1,1,3,862,862,0.85714
480,0,1,1,3,504,504,0.85714
240,69,0,0,3,264,195,0.14286
480,-7,0,1,3,487,494,0.85714
240,55,0,0,3,289,234,0.14286
480,0,1,1,3,451,451,0.85714
0,0,1,0,2,23,23,0.28571
840,0,1,1,1,799,799,0.57143
0,0,1,1,2,-42,-42,0.71429
0,-30,0,0,2,2,32,0.28571
840,-15,0,1,2,825,840,0.71429
840,16,0,1,1,821,805,0.57143
840,0,1,1,1,828,828,0.57143
480,0,1,1,1,477,477,0.57143
840,0,1,1,1,855,855,0.57143
840,0,1,1,1,851,851,0.57143
840,13,0,1,2,850,837,0.71429
0,9,0,1,3,-40,-49,0.85714
480,26,0,1,2,490,464,0.71429
480,0,1,1,2,446,446,0.71429
480,95,0,0,3,541,446,0.14286
840,13,0,0,3,840,827,0.14286
840,-8,0,1,3,850,858,0.85714
240,52,0,0,3,243,191,0.14286
480,0,1,0,3,444,444,0.14286
240,0,1,0,3,226,226,0.14286
240,-18,0,1,1,262,280,0.57143
480,0,1,0,3,524,524,0.14286
0,-8,0,0,2,-14,-6,0.28571
0,49,0,0,3,33,-16,0.14286
0,-33,0,0,2,-32,1,0.28571
0,-50,0,0,2,-28,22,0.28571
480,0,1,1,2,471,471,0.71429
840,0,1,0,2,836,836,0.28571
840,0,1,1,2,845,845,0.71429
840,53,0,1,2,854,801,0.71429
840,23,0,1,3,874,851,0.85714
240,53,0,0,3,286,233,0.14286
0,-16,0,0,2,22,38,0.28571
240,-16,0,0,4,219,235,0
480,-22,0,0,2,456,478,0.28571
840,14,0,0,2,846,832,0.28571
0,44,0,0,3,46,2,0.14286
240,0,1,1,2,262,262,0.71429
480,0,1,1,2,497,497,0.71429
0,0,1,1,2,16,16,0.71429
0,0,1,1,2,24,24,0.71429
240,0,1,1,1,261,261,0.57143
480,0,1,1,2,495,495,0.71429
480,0,1,1,2,480,480,0.71429
480,0,1,1,2,464,464,0.71429
480,0,1,1,2,461,461,0.71429
240,-15,0,1,3,228,243,0.85714
840,11,0,1,2,855,844,0.71429
840,37,0,1,2,850,813,0.71429
240,-14,0,1,2,215,229,0.71429
840,-46,0,1,2,822,868,0.71429
840,0,1,1,2,855,855,0.71429
240,-4,0,1,2,215,219,0.71429
240,0,1,1,2,255,255,0.71429
480,-5,0,1,3,464,469,0.85714
840,14,0,1,2,855,841,0.71429
240,1,0,1,2,257,256,0.71429
0,26,0,0,3,8,-18,0.14286
0,0,1,0,2,-12,-12,0.28571
0,0,1,1,2,12,12,0.71429
480,-12,0,1,2,463,475,0.71429
240,36,0,0,2,314,278,0.28571
480,0,1,1,2,476,476,0.71429
240,0,1,1,2,275,275,0.71429
0,0,1,1,2,20,20,0.71429
840,0,1,1,2,816,816,0.71429
240,11,0,1,2,244,233,0.71429
0,9,0,1,2,-9,-18,0.71429
840,11,0,1,2,864,853,0.71429
480,0,1,1,2,443,443,0.71429
480,0,1,1,3,484,484,0.85714
480,-5,0,0,1,462,467,0.42857
0,-22,0,0,2,-9,13,0.28571
0,0,1,1,2,20,20,0.71429
240,0,1,1,2,251,251,0.71429
0,7,0,1,2,3,-4,0.71429
0,0,1,1,3,-19,-19,0.85714
0,25,0,0,3,5,-20,0.14286
240,15,0,0,3,248,233,0.14286
480,0,1,1,2,495,495,0.71429
240,-5,0,1,3,257,262,0.85714
840,0,1,1,3,863,863,0.85714
240,0,1,1,2,226,226,0.71429
840,0,1,1,2,820,820,0.71429
840,-50,0,1,2,774,824,0.71429
840,0,1,1,2,891,891,0.71429
480,0,1,1,2,437,437,0.71429
480,0,1,1,3,502,502,0.85714
840,-42,0,0,2,832,874,0.28571
0,13,0,0,1,-18,-31,0.42857
840,0,1,1,2,842,842,0.71429
0,30,0,0,2,2,-28,0.28571
0,-37,0,0,2,-42,-5,0.28571
480,0,1,1,2,483,483,0.71429
480,0,1,1,2,494,494,0.71429
840,15,0,1,2,840,825,0.71429
480,36,0,1,2,442,406,0.71429
0,0,1,0,3,11,11,0.14286
0,0,1,1,2,13,13,0.71429
480,70,0,1,3,490,420,0.85714
240,20,0,1,2,246,226,0.71429
480,0,1,1,3,517,517,0.85714
0,0,1,0,2,3,3,0.28571
0,-26,0,0,3,-16,10,0.14286
240,0,1,1,3,260,260,0.85714
840,-28,0,1,3,828,856,0.85714
480,-44,0,0,3,440,484,0.14286
240,0,1,1,3,245,245,0.85714
0,-53,0,0,3,-33,20,0.14286
0,-11,0,0,2,4,15,0.28571
840,-14,0,1,2,835,849,0.71429
480,0,1,1,2,504,504,0.71429
840,28,0,1,2,816,788,0.71429
0,29,0,0,2,32,3,0.28571
240,-22,0,1,2,196,218,0.71429
840,3,0,1,3,857,854,0.85714
480,0,1,1,3,502,502,0.85714
0,0,1,1,4,54,54,1
0,-14,0,0,3,1,15,0.14286
840,0,1,1,2,817,817,0.71429
840,0,1,1,2,833,833,0.71429
0,0,1,1,2,22,22,0.71429
240,9,0,1,1,237,228,0.57143
480,0,1,1,1,481,481,0.57143
840,52,0,0,2,890,838,0.28571
240,0,1,0,1,241,241,0.42857
480,0,1,1,2,464,464,0.71429
0,-31,0,0,3,-25,6,0.14286
0,0,1,0,2,-6,-6,0.28571
0,0,1,1,2,-7,-7,0.71429
840,-1,0,1,2,856,857,0.71429
0,0,1,1,2,-23,-23,0.71429
0,40,0,0,3,31,-9,0.14286
240,-36,0,0,2,278,314,0.28571
240,-13,0,0,2,227,240,0.28571
240,-23,0,0,2,251,274,0.28571
480,16,0,1,2,492,476,0.71429
480,-28,0,1,3,458,486,0.85714
840,0,1,1,2,861,861,0.71429
840,25,0,1,2,849,824,0.71429
480,-11,0,1,2,485,496,0.71429
0,-7,0,0,3,3,10,0.14286
840,51,0,0,2,878,827,0.28571
480,0,1,1,2,475,475,0.71429
840,0,1,1,2,816,816,0.71429
480,0,1,1,2,453,453,0.71429
0,-14,0,0,2,-24,-10,0.28571
480,18,0,0,2,505,487,0.28571
0,14,0,0,2,-11,-25,0.28571
0,28,0,0,2,-6,-34,0.28571
840,26,0,1,2,838,812,0.71429
840,0,1,1,2,845,845,0.71429
240,0,1,1,3,228,228,0.85714
0,1,0,1,2,-10,-11,0.71429
240,0,1,1,2,229,229,0.71429
480,21,0,1,2,461,440,0.71429
240,18,0,1,2,246,228,0.71429
480,0,1,1,2,499,499,0.71429
240,0,1,1,2,245,245,0.71429
240,0,1,1,2,236,236,0.71429
480,28,0,1,3,490,462,0.85714
840,0,1,1,3,864,864,0.85714
0,0,1,1,2,63,63,0.71429
240,-24,0,1,2,216,240,0.71429
840,22,0,1,2,865,843,0.71429
240,-49,0,0,3,189,238,0.14286
240,0,1,1,2,284,284,0.71429
840,-20,0,1,2,818,838,0.71429
240,0,1,1,2,231,231,0.71429
240,-8,0,1,2,236,244,0.71429
840,53,0,1,2,865,812,0.71429
0,0,1,1,2,-20,-20,0.71429
480,-49,0,0,2,469,518,0.28571
840,0,1,1,2,824,824,0.71429
480,0,1,1,2,536,536,0.71429
240,0,1,1,2,240,240,0.71429
0,0,1,1,2,19,19,0.71429
240,-42,0,0,2,204,246,0.28571
480,0,1,1,2,500,500,0.71429
0,-5,0,0,2,18,23,0.28571
0,33,0,0,3,1,-32,0.14286
0,0,1,1,2,15,15,0.71429
0,0,1,1,3,0,0,0.85714
240,-53,0,0,3,201,254,0.14286
480,0,1,1,3,477,477,0.85714
840,0,1,1,2,847,847,0.71429
0,-25,0,0,3,-20,5,0.14286
840,25,0,1,2,863,838,0.71429
240,0,1,1,3,207,207,0.85714
480,0,1,1,2,472,472,0.71429
240,-16,0,1,2,205,221,0.71429
0,-20,0,0,3,-24,-4,0.14286
840,0,1,1,3,858,858,0.85714
0,6,0,1,4,-2,-8,1
480,-13,0,1,4,481,494,1
240,0,1,1,3,207,207,0.85714
0,14,0,0,2,23,9,0.28571
240,-56,0,0,3,206,262,0.14286
840,25,0,1,2,855,830,0.71429
840,0,1,1,2,879,879,0.71429
240,-29,0,0,2,224,253,0.28571
0,-26,0,0,2,-18,8,0.28571
480,14,0,1,2,497,483,0.71429
840,41,0,1,2,862,821,0.71429
840,-30,0,1,2,833,863,0.71429
0,-54,0,0,2,-16,38,0.28571
240,4,0,1,2,219,215,0.71429
0,27,0,0,2,10,-17,0.28571
240,30,0,0,2,272,242,0.28571
0,-11,0,0,2,-7,4,0.28571
0,0,1,0,2,14,14,0.28571
840,7,0,1,2,836,829,0.71429
0,0,1,1,2,1,1,0.71429
480,0,1,1,2,482,482,0.71429
840,0,1,1,2,832,832,0.71429
480,0,1,1,3,476,476,0.85714
480,0,1,1,2,500,500,0.71429
480,0,1,1,2,513,513,0.71429
0,0,1,1,2,15,15,0.71429
240,0,1,1,3,270,270,0.85714
240,0,1,1,3,241,241,0.85714
480,5,0,1,3,477,472,0.85714
480,0,1,1,3,495,495,0.85714
480,0,1,1,3,497,497,0.85714
840,-31,0,1,3,834,865,0.85714
0,0,1,1,4,-24,-24,1
840,66,0,0,3,883,817,0.14286
480,0,1,1,2,492,492,0.71429
480,17,0,1,2,483,466,0.71429
840,41,0,0,2,873,832,0.28571
240,0,1,1,2,241,241,0.71429
240,5,0,0,2,246,241,0.28571
0,-12,0,0,2,4,16,0.28571
840,13,0,1,2,832,819,0.71429
240,-23,0,0,2,200,223,0.28571
480,0,1,1,2,458,458,0.71429
240,-14,0,0,2,196,210,0.28571
240,-43,0,0,2,212,255,0.28571
0,26,0,0,2,8,-18,0.28571
0,0,1,0,2,-0,-0,0.28571
0,0,1,1,2,20,20,0.71429
480,0,1,1,2,499,499,0.71429
240,-3,0,0,2,241,244,0.28571
0,49,0,0,3,24,-25,0.14286
840,57,0,0,3,865,808,0.14286
0,37,0,0,3,26,-11,0.14286
0,0,1,0,2,31,31,0.28571
0,0,1,0,2,38,38,0.28571
0,0,1,1,2,34,34,0.71429
0,0,1,1,3,-17,-17,0.85714
480,0,1,1,3,483,483,0.85714
480,-14,0,1,2,466,480,0.71429
480,-14,0,1,2,469,483,0.71429
840,0,1,1,2,837,837,0.71429
480,0,1,1,2,485,485,0.71429
240,0,1,1,2,236,236,0.71429
840,-13,0,1,2,840,853,0.71429
0,34,0,0,3,36,2,0.14286
480,0,1,1,2,507,507,0.71429
240,42,0,0,4,262,220,0
240,-9,0,1,4,267,276,1
240,0,1,1,4,254,254,1
840,48,0,1,3,852,804,0.85714
0,0,1,1,3,5,5,0.85714
480,15,0,1,3,478,463,0.85714
480,8,0,1,3,500,492,0.85714
0,-76,0,0,3,-58,18,0.14286
480,0,1,1,2,477,477,0.71429
480,-24,0,1,2,481,505,0.71429
0,0,1,1,2,16,16,0.71429
840,0,1,1,3,841,841,0.85714
480,16,0,1,2,513,497,0.71429
480,0,1,1,3,503,503,0.85714
840,0,1,1,3,835,835,0.85714
480,0,1,1,3,491,491,0.85714
240,0,1,1,2,227,227,0.71429
480,-32,0,1,2,477,509,0.71429
840,19,0,1,2,852,833,0.71429
0,0,1,1,2,-18,-18,0.71429
480,32,0,1,2,489,457,0.71429
840,-23,0,1,2,829,852,0.71429
0,0,1,1,2,51,51,0.71429
480,1,0,1,2,504,503,0.71429
840,0,1,1,2,805,805,0.71429
0,0,1,1,2,31,31,0.71429
840,17,0,1,2,859,842,0.71429
240,0,1,1,2,242,242,0.71429
840,0,1,1,2,861,861,0.71429
840,0,1,1,2,870,870,0.71429
240,0,1,1,2,222,222,0.71429
240,-3,0,1,2,237,240,0.71429
240,37,0,0,2,235,198,0.28571
840,0,1,1,3,814,814,0.85714
240,0,1,1,2,272,272,0.71429
480,0,1,1,2,544,544,0.71429
0,-20,0,0,3,-27,-7,0.14286
0,0,1,1,2,-5,-5,0.71429
0,0,1,1,2,-19,-19,0.71429
0,8,0,1,2,-17,-25,0.71429
840,-3,0,1,3,862,865,0.85714
240,0,1,1,2,242,242,0.71429
0,0,1,1,4,-12,-12,1
480,0,1,1,3,496,496,0.85714
840,0,1,1,2,851,851,0.71429
0,1,0,1,4,4,3,1
0,0,1,1,4,-21,-21,1
0,68,0,0,4,37,-31,0
480,43,0,1,2,496,453,0.71429
840,0,1,1,2,805,805,0.71429
480,44,0,0,2,501,457,0.28571
840,13,0,0,2,859,846,0.28571
240,-5,0,0,2,237,242,0.28571
840,0,1,1,2,843,843,0.71429
0,46,0,0,2,28,-18,0.28571
480,0,1,1,2,476,476,0.71429
480,22,0,1,2,496,474,0.71429
840,34,0,1,2,866,832,0.71429
240,-46,0,0,2,208,254,0.28571
840,-15,0,0,3,833,848,0.14286
840,-4,0,1,2,872,876,0.71429
840,0,1,1,2,816,816,0.71429
0,0,1,1,2,-9,-9,0.71429
240,22,0,1,2,236,214,0.71429
0,-40,0,0,2,-45,-5,0.28571
240,106,0,0,3,297,191,0.14286
0,-13,0,0,2,-15,-2,0.28571
240,59,0,0,2,291,232,0.28571
240,0,1,1,2,230,230,0.71429
240,0,1,1,2,277,277,0.71429
480,-35,0,1,2,482,517,0.71429
0,10,0,0,2,17,7,0.28571
480,0,1,1,2,450,450,0.71429
840,39,0,1,2,869,830,0.71429
0,0,1,1,1,10,10,0.57143
240,0,1,1,3,234,234,0.85714
240,-18,0,1,2,208,226,0.71429
240,0,1,1,2,237,237,0.71429
480,0,1,1,3,465,465,0.85714
840,0,1,1,3,840,840,0.85714
0,0,1,1,3,-44,-44,0.85714
240,-4,0,1,2,221,225,0.71429
480,37,0,1,2,479,442,0.71429
240,0,1,0,2,240,240,0.28571
240,0,1,0,2,262,262,0.28571
840,0,1,1,1,884,884,0.57143
0,16,0,1,2,17,1,0.71429
840,16,0,0,2,835,819,0.28571
240,0,1,0,2,251,251,0.28571
840,-16,0,1,1,881,897,0.57143
840,0,1,1,1,855,855,0.57143
240,0,1,1,1,220,220,0.57143
240,-13,0,1,1,209,222,0.57143
240,14,0,1,1,257,243,0.57143
840,25,0,1,1,843,818,0.57143
0,4,0,1,3,-3,-7,0.85714
840,0,1,1,2,845,845,0.71429
0,0,1,0,2,3,3,0.28571
480,0,1,1,2,501,501,0.71429
0,0,1,1,2,18,18,0.71429
240,-1,0,1,2,232,233,0.71429
480,0,1,1,2,488,488,0.71429
0,15,0,0,3,45,30,0.14286
240,-8,0,0,2,248,256,0.28571
480,0,1,0,2,476,476,0.28571
480,0,1,0,2,442,442,0.28571
840,-61,0,0,2,816,877,0.28571
840,14,0,1,2,839,825,0.71429
240,16,0,0,2,278,262,0.28571
840,0,1,0,2,806,806,0.28571
240,0,1,0,2,245,245,0.28571
480,-10,0,1,2,475,485,0.71429
240,0,1,0,2,221,221,0.28571
0,-22,0,0,3,3,25,0.14286
840,0,1,0,2,828,828,0.28571
480,0,1,1,2,465,465,0.71429
0,0,1,0,2,29,29,0.28571
0,-1,0,1,2,17,18,0.71429
480,-11,0,1,2,481,492,0.71429
840,0,1,1,2,811,811,0.71429
480,0,1,1,2,494,494,0.71429
240,0,1,1,2,268,268,0.71429
480,20,0,1,2,476,456,0.71429
840,0,1,1,2,850,850,0.71429
840,0,1,1,2,846,846,0.71429
240,0,1,1,2,278,278,0.71429
840,0,1,1,2,816,816,0.71429
240,8,0,1,2,234,226,0.71429
480,-17,0,0,2,487,504,0.28571
0,0,1,1,1,25,25,0.57143
0,0,1,0,2,-10,-10,0.28571
480,8,0,1,2,498,490,0.71429
840,24,0,1,2,868,844,0.71429
840,0,1,0,2,876,876,0.28571
0,0,1,1,1,12,12,0.57143
480,0,1,1,2,467,467,0.71429
480,0,1,1,2,480,480,0.71429
240,0,1,0,2,261,261,0.28571
840,0,1,1,2,881,881,0.71429
240,-6,0,1,2,256,262,0.71429
840,-7,0,1,2,851,858,0.71429
0,-3,0,1,2,22,25,0.71429
240,40,0,0,2,233,193,0.28571
840,0,1,1,2,870,870,0.71429
840,11,0,1,1,849,838,0.57143
240,-47,0,0,3,215,262,0.14286
480,28,0,0,2,503,475,0.28571
240,0,1,0,2,212,212,0.28571
840,49,0,0,2,865,816,0.28571
480,0,1,0,2,458,458,0.28571
240,0,1,0,2,252,252,0.28571
240,0,1,0,2,251,251,0.28571
240,-20,0,0,2,231,251,0.28571
480,-52,0,0,2,431,483,0.28571
840,0,1,0,2,862,862,0.28571
840,0,1,0,2,831,831,0.28571
840,50,0,0,3,862,812,0.14286
240,-47,0,0,2,251,298,0.28571
240,0,1,0,2,261,261,0.28571
840,25,0,0,2,858,833,0.28571
240,-13,0,0,2,220,233,0.28571
240,-9,0,0,2,191,200,0.28571
0,-8,0,0,2,10,18,0.28571
0,0,1,1,2,10,10,0.71429
840,0,1,1,2,864,864,0.71429
480,0,1,0,2,506,506,0.28571
840,-44,0,0,2,842,886,0.28571
480,0,1,0,2,515,515,0.28571
240,8,0,0,3,263,255,0.14286
840,0,1,1,2,818,818,0.71429
480,0,1,1,2,489,489,0.71429
240,17,0,0,2,256,239,0.28571
240,-28,0,0,2,208,236,0.28571
840,0,1,0,2,789,789,0.28571
240,52,0,0,3,262,210,0.14286
840,0,1,0,2,834,834,0.28571
0,0,1,0,2,4,4,0.28571
240,0,1,0,2,215,215,0.28571
480,0,1,0,2,437,437,0.28571
0,0,1,1,2,-43,-43,0.71429
480,0,1,1,2,501,501,0.71429
840,0,1,0,2,823,823,0.28571
480,-37,0,0,2,455,492,0.28571
840,0,1,0,3,836,836,0.14286
480,-39,0,0,2,470,509,0.28571
240,67,0,0,2,269,202,0.28571
240,0,1,0,2,271,271,0.28571
0,0,1,1,2,-42,-42,0.71429
480,22,0,1,2,482,460,0.71429
480,-21,0,1,2,473,494,0.71429
0,0,1,1,2,18,18,0.71429
840,-15,0,1,2,847,862,0.71429
240,0,1,1,2,205,205,0.71429
240,0,1,1,2,263,263,0.71429
480,0,1,1,2,455,455,0.71429
480,30,0,1,1,496,466,0.57143
480,0,1,1,2,478,478,0.71429
480,11,0,1,2,463,452,0.71429
480,0,1,1,2,471,471,0.71429
0,0,1,1,2,-25,-25,0.71429
480,0,1,1,2,508,508,0.71429
480,14,0,1,2,462,448,0.71429
840,0,1,1,2,833,833,0.71429
0,56,0,0,4,25,-31,0
0,-26,0,0,3,1,27,0.14286
480,28,0,1,2,478,450,0.71429
840,0,1,1,1,846,846,0.57143
240,6,0,1,1,232,226,0.57143
0,0,1,1,3,2,2,0.85714
840,3,0,1,2,829,826,0.71429
840,0,1,1,2,821,821,0.71429
840,0,1,1,2,830,830,0.71429
240,0,1,1,2,246,246,0.71429
240,13,0,0,2,242,229,0.28571
0,0,1,1,2,29,29,0.71429
840,27,0,1,2,860,833,0.71429
240,8,0,1,1,261,253,0.57143
840,4,0,1,1,833,829,0.57143
0,-21,0,0,2,5,26,0.28571
0,5,0,0,2,-11,-16,0.28571
240,0,1,1,1,252,252,0.57143
480,0,1,1,1,479,479,0.57143
480,-43,0,1,2,486,529,0.71429
840,0,1,1,2,806,806,0.71429
840,0,1,1,3,819,819,0.85714
840,-36,0,1,2,832,868,0.71429
840,0,1,1,2,837,837,0.71429
840,12,0,1,2,835,823,0.71429
0,0,1,1,2,-10,-10,0.71429
0,0,1,1,2,15,15,0.71429
240,0,1,1,2,228,228,0.71429
840,27,0,1,2,856,829,0.71429
840,-11,0,1,2,814,825,0.71429
480,1,0,1,2,485,484,0.71429
0,-11,0,1,2,13,24,0.71429
0,0,1,1,2,-12,-12,0.71429
840,0,1,1,2,848,848,0.71429
480,0,1,1,2,502,502,0.71429
480,20,0,1,2,483,463,0.71429
840,0,1,1,2,849,849,0.71429
0,-37,0,0,3,-27,10,0.14286
240,0,1,1,2,248,248,0.71429
480,0,1,1,2,469,469,0.71429
840,0,1,1,2,875,875,0.71429
840,-17,0,1,2,836,853,0.71429
240,0,1,1,2,263,263,0.71429
0,-13,0,0,3,0,13,0.14286
0,0,1,1,2,-42,-42,0.71429
240,-3,0,1,2,243,246,0.71429
240,0,1,1,2,237,237,0.71429
840,-22,0,1,1,822,844,0.57143
240,36,0,0,2,259,223,0.28571
840,32,0,0,2,856,824,0.28571
0,0,1,1,1,9,9,0.57143
840,-22,0,1,2,848,870,0.71429
240,-19,0,0,3,246,265,0.14286
480,28,0,1,2,510,482,0.71429
240,0,1,1,2,225,225,0.71429
840,-3,0,0,3,831,834,0.14286
0,0,1,1,2,4,4,0.71429
0,29,0,0,2,14,-15,0.28571
840,0,1,1,2,845,845,0.71429
0,-21,0,0,2,-27,-6,0.28571
0,0,1,1,2,24,24,0.71429
480,-28,0,1,2,478,506,0.71429
0,0,1,1,2,-10,-10,0.71429
0,0,1,1,1,-31,-31,0.57143
0,0,1,1,2,58,58,0.71429
240,17,0,0,2,251,234,0.28571
240,0,1,1,2,196,196,0.71429
0,0,1,1,2,-33,-33,0.71429
480,0,1,1,2,453,453,0.71429
0,0,1,1,2,22,22,0.71429
0,0,1,1,2,7,7,0.71429
0,0,1,1,2,9,9,0.71429
840,-1,0,1,2,830,831,0.71429
840,59,0,0,2,869,810,0.28571
480,0,1,1,2,493,493,0.71429
840,0,1,1,2,858,858,0.71429
480,0,1,1,2,505,505,0.71429
480,0,1,1,2,454,454,0.71429
240,-13,0,1,3,237,250,0.85714
0,-30,0,1,2,-28,2,0.71429
480,0,1,1,3,468,468,0.85714
480,-15,0,1,2,436,451,0.71429
240,0,1,1,2,238,238,0.71429
0,0,1,1,3,3,3,0.85714
480,-17,0,1,2,484,501,0.71429
480,46,0,1,2,549,503,0.71429
240,0,1,1,2,270,270,0.71429
840,0,1,1,2,804,804,0.71429
480,0,1,1,2,522,522,0.71429
840,0,1,1,2,817,817,0.71429
240,-53,0,0,2,233,286,0.28571
240,0,1,1,2,181,181,0.71429
0,15,0,1,2,4,-11,0.71429
840,4,0,1,1,839,835,0.57143
240,-69,0,0,2,195,264,0.28571
480,0,1,0,2,492,492,0.28571
0,0,1,1,2,-12,-12,0.71429
0,0,1,1,2,-40,-40,0.71429
480,0,1,1,2,472,472,0.71429
0,0,1,1,1,13,13,0.57143
840,0,1,1,2,834,834,0.71429
0,0,1,1,2,13,13,0.71429
240,37,0,0,2,261,224,0.28571
240,-23,0,0,2,256,279,0.28571
840,22,0,1,2,838,816,0.71429
840,0,1,0,2,835,835,0.28571
240,-11,0,1,2,237,248,0.71429
0,-6,0,1,2,-11,-5,0.71429
0,64,0,0,2,47,-17,0.28571
480,18,0,0,2,520,502,0.28571
240,17,0,0,2,271,254,0.28571
0,-31,0,0,3,-32,-1,0.14286
480,11,0,1,2,512,501,0.71429
840,0,1,1,2,835,835,0.71429
480,22,0,1,2,493,471,0.71429
240,-1,0,1,3,222,223,0.85714
0,0,1,1,2,-4,-4,0.71429
240,0,1,1,2,191,191,0.71429
240,-13,0,1,2,260,273,0.71429
0,-13,0,0,2,-9,4,0.28571
240,-31,0,0,2,239,270,0.28571
0,0,1,0,2,-14,-14,0.28571
480,-42,0,0,1,460,502,0.42857
480,-3,0,1,1,470,473,0.57143
240,0,1,1,2,234,234,0.71429
480,0,1,1,2,443,443,0.71429
240,4,0,1,1,270,266,0.57143
0,-43,0,0,4,-28,15,0
240,0,1,1,2,211,211,0.71429
240,-37,0,0,2,220,257,0.28571
840,-1,0,0,2,851,852,0.28571
480,-33,0,0,2,436,469,0.28571
240,0,1,1,2,193,193,0.71429
240,-18,0,1,2,239,257,0.71429
480,16,0,1,2,478,462,0.71429
480,0,1,1,2,462,462,0.71429
240,-12,0,1,2,230,242,0.71429
840,0,1,1,2,860,860,0.71429
240,0,1,1,2,251,251,0.71429
480,0,1,1,3,453,453,0.85714
840,50,0,1,2,824,774,0.71429
840,0,1,1,2,791,791,0.71429
840,4,0,1,2,850,846,0.71429
480,0,1,1,3,524,524,0.85714
0,0,1,1,2,-12,-12,0.71429
840,0,1,1,2,882,882,0.71429
840,-14,0,1,2,834,848,0.71429
480,-39,0,1,2,453,492,0.71429
0,-3,0,1,2,-3,-0,0.71429
0,-14,0,1,3,-3,11,0.85714
480,0,1,1,2,436,436,0.71429
480,0,1,1,2,443,443,0.71429
480,0,1,1,2,480,480,0.71429
480,0,1,1,2,477,477,0.71429
0,-18,0,0,2,-24,-6,0.28571
840,0,1,1,2,793,793,0.71429
840,0,1,1,2,825,825,0.71429
480,0,1,1,2,497,497,0.71429
240,-55,0,0,3,234,289,0.14286
480,0,1,0,2,512,512,0.28571
240,35,0,0,2,239,204,0.28571
240,0,1,0,2,262,262,0.28571
0,0,1,1,1,-6,-6,0.57143
840,0,1,1,1,860,860,0.57143
240,9,0,1,2,218,209,0.71429
840,-7,0,1,2,836,843,0.71429
240,48,0,0,2,238,190,0.28571
0,0,1,1,2,-40,-40,0.71429
240,0,1,1,2,225,225,0.71429
0,0,1,1,2,30,30,0.71429
480,0,1,1,1,443,443,0.57143
240,0,1,1,1,249,249,0.57143
480,0,1,1,1,492,492,0.57143
480,-39,0,0,2,459,498,0.28571
0,43,0,0,2,19,-24,0.28571
0,-34,0,0,3,2,36,0.14286
0,0,1,1,2,-46,-46,0.71429
480,-2,0,1,1,479,481,0.57143
240,-57,0,0,2,218,275,0.28571
840,18,0,0,2,847,829,0.28571
840,-8,0,0,2,849,857,0.28571
0,12,0,1,2,-13,-25,0.71429
240,5,0,1,2,227,222,0.71429
0,-43,0,0,2,-19,24,0.28571
840,0,1,1,1,854,854,0.57143
0,0,1,1,2,28,28,0.71429
480,0,1,1,1,503,503,0.57143
480,0,1,1,1,514,514,0.57143
840,-72,0,1,2,801,873,0.71429
240,0,1,1,2,252,252,0.71429
480,4,0,1,2,493,489,0.71429
240,0,1,1,2,286,286,0.71429
0,0,1,1,2,-9,-9,0.71429
840,0,1,1,2,882,882,0.71429
240,39,0,0,3,273,234,0.14286
0,-45,0,0,3,-38,7,0.14286
480,0,1,0,2,445,445,0.28571
840,0,1,0,1,891,891,0.42857
480,0,1,1,1,493,493,0.57143
840,20,0,1,1,863,843,0.57143
480,5,0,1,1,502,497,0.57143
840,5,0,1,1,851,846,0.57143
480,-49,0,0,2,464,513,0.28571
0,0,1,1,1,-77,-77,0.57143
480,0,1,1,1,451,451,0.57143
840,-28,0,1,1,856,884,0.57143
840,-36,0,1,1,812,848,0.57143
840,0,1,1,1,831,831,0.57143
0,0,1,1,2,-5,-5,0.71429
840,0,1,1,2,871,871,0.71429
240,0,1,1,2,249,249,0.71429
840,28,0,1,2,849,821,0.71429
240,-51,0,0,2,218,269,0.28571
0,0,1,1,2,21,21,0.71429
0,41,0,0,2,32,-9,0.28571
840,0,1,1,2,831,831,0.71429
240,0,1,1,2,234,234,0.71429
0,-9,0,0,2,-10,-1,0.28571
840,0,1,1,1,818,818,0.57143
240,-2,0,1,2,244,246,0.71429
0,10,0,1,2,-19,-29,0.71429
240,0,1,1,2,214,214,0.71429
240,-14,0,1,2,232,246,0.71429
480,20,0,1,2,480,460,0.71429
480,-10,0,1,2,445,455,0.71429
480,0,1,1,2,507,507,0.71429
240,17,0,1,2,254,237,0.71429
480,-61,0,1,2,471,532,0.71429
480,28,0,1,2,520,492,0.71429
840,0,1,1,2,843,843,0.71429
480,0,1,1,2,427,427,0.71429
480,35,0,0,1,484,449,0.42857
480,7,0,0,1,494,487,0.42857
240,-25,0,0,3,198,223,0.14286
240,0,1,0,3,202,202,0.14286
840,0,1,1,2,835,835,0.71429
240,0,1,0,3,286,286,0.14286
840,20,0,1,1,835,815,0.57143
0,-26,0,0,4,-33,-7,0
0,-26,0,0,4,-1,25,0
480,35,0,0,3,504,469,0.14286
840,0,1,0,1,812,812,0.42857
240,0,1,1,3,246,246,0.85714
0,35,0,0,3,1,-34,0.14286
840,14,0,1,2,825,811,0.71429
480,-36,0,0,3,465,501,0.14286
480,0,1,0,2,537,537,0.28571
840,8,0,0,2,844,836,0.28571
0,53,0,0,4,39,-14,0
480,-9,0,1,2,482,491,0.71429
0,0,1,1,2,21,21,0.71429
840,-26,0,1,2,838,864,0.71429
240,0,1,1,3,271,271,0.85714
480,0,1,1,2,508,508,0.71429
0,0,1,1,2,-13,-13,0.71429
0,0,1,1,4,-1,-1,1
480,0,1,1,3,465,465,0.85714
240,32,0,0,2,262,230,0.28571
480,0,1,1,2,450,450,0.71429
0,14,0,0,2,-6,-20,0.28571
240,15,0,0,2,266,251,0.28571
840,-34,0,1,2,827,861,0.71429
480,0,1,1,2,494,494,0.71429
0,0,1,1,2,6,6,0.71429
0,0,1,1,2,5,5,0.71429
0,14,0,1,2,-4,-18,0.71429
240,40,0,0,2,267,227,0.28571
480,-8,0,1,2,497,505,0.71429
840,0,1,1,2,873,873,0.71429
0,0,1,1,2,-27,-27,0.71429
480,87,0,0,2,533,446,0.28571
480,19,0,0,2,493,474,0.28571
240,-66,0,0,3,231,297,0.14286
240,0,1,1,2,237,237,0.71429
480,0,1,1,2,483,483,0.71429
840,0,1,1,2,836,836,0.71429
840,0,1,1,2,831,831,0.71429
0,0,1,0,2,-0,-0,0.28571
240,-12,0,0,2,238,250,0.28571
240,9,0,0,2,241,232,0.28571
240,5,0,1,2,220,215,0.71429
240,0,1,1,3,242,242,0.85714
480,0,1,1,2,440,440,0.71429
0,40,0,0,2,27,-13,0.28571
840,0,1,1,2,808,808,0.71429
240,4,0,1,3,223,219,0.85714
480,32,0,0,2,480,448,0.28571
840,-18,0,1,3,772,790,0.85714
840,5,0,1,3,829,824,0.85714
840,0,1,1,3,852,852,0.85714
840,46,0,0,2,876,830,0.28571
240,-4,0,1,2,212,216,0.71429
240,0,1,1,2,228,228,0.71429
240,-3,0,1,2,233,236,0.71429
0,0,1,1,2,11,11,0.71429
0,-15,0,0,3,-9,6,0.14286
240,0,1,1,2,269,269,0.71429
0,0,1,1,2,47,47,0.71429
240,-7,0,1,3,264,271,0.85714
480,0,1,1,3,463,463,0.85714
240,31,0,1,2,256,225,0.71429
240,0,1,1,3,264,264,0.85714
480,0,1,1,3,457,457,0.85714
840,0,1,1,3,838,838,0.85714
240,0,1,1,4,281,281,1
240,0,1,1,4,171,171,1
480,0,1,1,3,510,510,0.85714
240,18,0,1,2,259,241,0.71429
480,0,1,1,2,439,439,0.71429
240,43,0,1,2,263,220,0.71429
0,-8,0,0,2,-9,-1,0.28571
840,0,1,1,2,805,805,0.71429
840,0,1,1,2,886,886,0.71429
840,0,1,1,2,885,885,0.71429
0,-33,0,0,3,4,37,0.14286
0,-16,0,0,3,-0,16,0.14286
240,0,1,1,2,243,243,0.71429
240,0,1,1,2,249,249,0.71429
840,0,1,1,2,850,850,0.71429
840,0,1,1,2,840,840,0.71429
480,-31,0,1,2,441,472,0.71429
840,0,1,1,2,832,832,0.71429
240,-17,0,1,3,221,238,0.85714
840,-1,0,1,2,877,878,0.71429
840,0,1,1,2,889,889,0.71429
240,0,1,1,2,266,266,0.71429
840,0,1,0,2,828,828,0.28571
0,0,1,1,4,3,3,1
480,-13,0,1,2,437,450,0.71429
840,-20,0,1,2,826,846,0.71429
240,48,0,0,3,278,230,0.14286
840,0,1,1,2,832,832,0.71429
840,0,1,0,2,831,831,0.28571
840,67,0,0,3,867,800,0.14286
840,0,1,1,2,838,838,0.71429
840,-96,0,0,2,799,895,0.28571
840,29,0,0,2,862,833,0.28571
840,0,1,0,1,838,838,0.42857
840,0,1,1,2,811,811,0.71429
840,-3,0,1,3,864,867,0.85714
240,0,1,1,2,239,239,0.71429
480,-45,0,0,3,442,487,0.14286
0,22,0,0,2,8,-14,0.28571
840,0,1,0,2,823,823,0.28571
840,39,0,0,1,861,822,0.42857
480,0,1,1,1,432,432,0.57143
840,0,1,1,2,838,838,0.71429
480,0,1,1,2,478,478,0.71429
240,0,1,1,2,210,210,0.71429
480,-31,0,0,2,462,493,0.28571
840,0,1,1,2,859,859,0.71429
0,0,1,1,2,-9,-9,0.71429
480,0,1,1,2,504,504,0.71429
0,0,1,1,2,-7,-7,0.71429
240,-30,0,0,2,240,270,0.28571
840,0,1,1,2,863,863,0.71429
240,0,1,0,2,223,223,0.28571
480,0,1,1,2,439,439,0.71429
480,0,1,1,2,456,456,0.71429
240,0,1,0,1,253,253,0.42857
0,0,1,0,1,-8,-8,0.42857
480,0,1,0,1,498,498,0.42857
0,36,0,0,3,-2,-38,0.14286
0,-63,0,0,4,-8,55,0
0,0,1,0,3,1,1,0.14286
0,0,1,1,2,-19,-19,0.71429
0,4,0,0,2,20,16,0.28571
840,15,0,1,2,850,835,0.71429
480,-14,0,1,2,477,491,0.71429
480,0,1,1,2,464,464,0.71429
480,0,1,0,2,439,439,0.28571
480,0,1,1,2,488,488,0.71429
840,0,1,1,2,824,824,0.71429
480,0,1,1,2,517,517,0.71429
480,0,1,1,2,449,449,0.71429
240,0,1,1,2,271,271,0.71429
240,48,0,0,3,271,223,0.14286
840,12,0,0,2,840,828,0.28571
0,0,1,1,2,-1,-1,0.71429
240,-42,0,0,3,224,266,0.14286
240,0,1,1,2,258,258,0.71429
240,-57,0,0,4,240,297,0
480,-1,0,1,2,494,495,0.71429
480,-6,0,1,3,475,481,0.85714
840,0,1,1,3,836,836,0.85714
480,54,0,1,2,491,437,0.71429
480,-47,0,0,4,447,494,0
480,-26,0,0,3,436,462,0.14286
840,89,0,0,4,876,787,0
480,-11,0,1,2,487,498,0.71429
240,0,1,0,2,209,209,0.28571
840,0,1,1,2,849,849,0.71429
0,18,0,0,3,4,-14,0.14286
480,30,0,0,2,490,460,0.28571
480,0,1,0,2,451,451,0.28571
0,-2,0,1,2,7,9,0.71429
480,0,1,0,4,509,509,0
480,0,1,1,2,473,473,0.71429
840,0,1,1,2,884,884,0.71429
480,-11,0,1,2,469,480,0.71429
480,0,1,1,2,510,510,0.71429
0,-6,0,0,2,9,15,0.28571
0,16,0,0,3,26,10,0.14286
0,0,1,1,2,21,21,0.71429
240,0,1,1,1,219,219,0.57143
840,0,1,1,1,838,838,0.57143
840,-7,0,1,1,847,854,0.57143
0,0,1,1,2,20,20,0.71429
0,-32,0,0,2,-22,10,0.28571
0,-9,0,0,2,1,10,0.28571
480,14,0,0,2,476,462,0.28571
480,-49,0,0,2,441,490,0.28571
480,-16,0,0,2,490,506,0.28571
0,0,1,1,2,8,8,0.71429
840,0,1,1,2,845,845,0.71429
240,7,0,1,2,242,235,0.71429
0,-2,0,1,2,-9,-7,0.71429
240,-19,0,1,2,223,242,0.71429
480,0,1,1,2,520,520,0.71429
480,10,0,1,2,473,463,0.71429
240,3,0,1,2,245,242,0.71429
840,0,1,1,2,850,850,0.71429
0,41,0,0,4,33,-8,0
840,-32,0,1,2,822,854,0.71429
480,0,1,1,2,492,492,0.71429
240,0,1,0,2,258,258,0.28571
0,0,1,1,2,-11,-11,0.71429
240,-4,0,1,2,234,238,0.71429
840,0,1,0,2,773,773,0.28571
0,22,0,0,2,11,-11,0.28571
240,2,0,0,2,255,253,0.28571
480,39,0,0,2,472,433,0.28571
480,-25,0,0,2,452,477,0.28571
240,0,1,1,2,205,205,0.71429
0,13,0,0,2,14,1,0.28571
240,2,0,0,1,266,264,0.42857
240,0,1,1,2,286,286,0.71429
0,-78,0,0,3,-42,36,0.14286
240,0,1,1,2,227,227,0.71429
240,-14,0,0,2,211,225,0.28571
240,0,1,0,2,228,228,0.28571
0,-28,0,0,3,0,28,0.14286
840,0,1,1,2,850,850,0.71429
840,21,0,0,3,852,831,0.14286
480,0,1,1,2,477,477,0.71429
0,0,1,1,2,-11,-11,0.71429
240,2,0,1,2,235,233,0.71429
480,0,1,1,2,477,477,0.71429
0,0,1,1,2,2,2,0.71429
840,0,1,1,2,855,855,0.71429
480,-8,0,1,2,457,465,0.71429
240,-42,0,0,2,210,252,0.28571
0,0,1,1,2,40,40,0.71429
840,13,0,1,2,847,834,0.71429
840,0,1,1,2,860,860,0.71429
840,53,0,1,2,851,798,0.71429
240,3,0,1,3,226,223,0.85714
480,-36,0,1,2,474,510,0.71429
840,0,1,1,2,848,848,0.71429
0,0,1,1,2,25,25,0.71429
240,2,0,1,2,231,229,0.71429
240,-19,0,1,2,228,247,0.71429
480,0,1,1,2,489,489,0.71429
240,0,1,1,3,209,209,0.85714
240,-32,0,1,2,249,281,0.71429
480,0,1,1,2,503,503,0.71429
0,47,0,0,3,46,-1,0.14286
480,-66,0,0,3,446,512,0.14286
0,32,0,0,3,24,-8,0.14286
840,0,1,1,2,878,878,0.71429
480,49,0,0,3,501,452,0.14286
240,0,1,1,2,235,235,0.71429
0,6,0,1,2,-18,-24,0.71429
240,16,0,0,2,238,222,0.28571
840,0,1,1,2,879,879,0.71429
240,-40,0,0,3,197,237,0.14286
240,0,1,0,2,242,242,0.28571
840,-25,0,1,2,812,837,0.71429
240,10,0,0,2,241,231,0.28571
240,0,1,0,2,224,224,0.28571
0,13,0,0,2,41,28,0.28571
480,-41,0,0,3,467,508,0.14286
0,0,1,1,2,-17,-17,0.71429
480,0,1,1,3,531,531,0.85714
840,13,0,1,3,854,841,0.85714
0,-23,0,0,3,-15,8,0.14286
0,37,0,0,2,43,6,0.28571
480,67,0,0,2,531,464,0.28571
0,45,0,0,2,17,-28,0.28571
0,0,1,0,2,8,8,0.28571
0,33,0,0,2,34,1,0.28571
0,21,0,0,2,-7,-28,0.28571
240,12,0,0,2,253,241,0.28571
840,0,1,0,2,782,782,0.28571
240,-4,0,0,2,228,232,0.28571
0,0,1,1,2,-14,-14,0.71429
0,0,1,1,2,-12,-12,0.71429
840,0,1,1,2,871,871,0.71429
240,41,0,0,3,262,221,0.14286
480,-33,0,1,2,486,519,0.71429
0,59,0,0,3,38,-21,0.14286
240,16,0,0,2,236,220,0.28571
480,-25,0,0,2,476,501,0.28571
480,0,1,1,2,488,488,0.71429
0,0,1,1,2,1,1,0.71429
480,0,1,1,2,480,480,0.71429
0,0,1,1,2,24,24,0.71429
240,0,1,1,2,210,210,0.71429
240,0,1,1,2,209,209,0.71429
840,0,1,1,2,842,842,0.71429
240,45,0,0,2,285,240,0.28571
0,27,0,0,2,-7,-34,0.28571
240,0,1,1,2,235,235,0.71429
0,-2,0,0,2,-3,-1,0.28571
840,0,1,1,2,841,841,0.71429
0,0,1,0,2,-20,-20,0.28571
480,0,1,1,2,458,458,0.71429
240,0,1,1,2,195,195,0.71429
480,0,1,1,2,470,470,0.71429
480,0,1,1,3,462,462,0.85714
0,0,1,1,2,-17,-17,0.71429
240,0,1,1,2,230,230,0.71429
240,0,1,1,2,254,254,0.71429
0,0,1,1,3,8,8,0.85714
840,-9,0,1,3,845,854,0.85714
240,67,0,0,3,266,199,0.14286
0,-34,0,0,3,-15,19,0.14286
0,0,1,1,2,-43,-43,0.71429
840,0,1,1,2,873,873,0.71429
0,-51,0,0,3,-21,30,0.14286
0,0,1,0,2,16,16,0.28571
840,-59,0,1,2,788,847,0.71429
480,0,1,1,2,460,460,0.71429
0,41,0,0,3,13,-28,0.14286
480,-5,0,1,2,500,505,0.71429
240,-1,0,1,2,208,209,0.71429
0,0,1,1,2,45,45,0.71429
480,0,1,1,2,440,440,0.71429
240,32,0,0,3,254,222,0.14286
480,0,1,1,2,514,514,0.71429
0,-2,0,1,2,-18,-16,0.71429
240,38,0,0,3,243,205,0.14286
840,0,1,1,2,914,914,0.71429
240,20,0,0,2,232,212,0.28571
480,0,1,1,2,493,493,0.71429
480,26,0,1,2,511,485,0.71429
840,0,1,1,3,872,872,0.85714
840,5,0,1,2,819,814,0.71429
840,24,0,1,2,857,833,0.71429
480,-27,0,1,2,463,490,0.71429
240,-23,0,1,2,257,280,0.71429
840,-7,0,1,2,846,853,0.71429
480,0,1,1,2,482,482,0.71429
480,-5,0,1,2,486,491,0.71429
240,0,1,1,2,267,267,0.71429
840,4,0,1,2,857,853,0.71429
840,116,0,0,2,896,780,0.28571
480,0,1,1,2,484,484,0.71429
480,-24,0,1,2,435,459,0.71429
240,0,1,1,2,206,206,0.71429
240,-3,0,1,2,239,242,0.71429
240,12,0,1,2,242,230,0.71429
240,10,0,1,2,261,251,0.71429
840,0,1,1,2,853,853,0.71429
0,0,1,1,2,23,23,0.71429
480,0,1,1,2,523,523,0.71429
0,0,1,1,2,-19,-19,0.71429
480,0,1,1,2,493,493,0.71429
240,0,1,1,2,287,287,0.71429
0,33,0,0,2,17,-16,0.28571
0,-14,0,0,2,-41,-27,0.28571
840,0,1,1,3,812,812,0.85714
840,0,1,1,2,832,832,0.71429
840,-15,0,1,2,839,854,0.71429
240,0,1,1,2,235,235,0.71429
480,9,0,1,2,438,429,0.71429
0,0,1,1,2,14,14,0.71429
0,0,1,1,2,13,13,0.71429
840,12,0,1,3,845,833,0.85714
240,95,0,0,3,276,181,0.14286
840,0,1,0,3,858,858,0.14286
840,0,1,0,2,873,873,0.28571
840,0,1,1,2,847,847,0.71429
480,-76,0,0,3,438,514,0.14286
480,-17,0,0,3,491,508,0.14286
480,0,1,1,2,492,492,0.71429
840,0,1,1,3,843,843,0.85714
480,0,1,1,3,511,511,0.85714
240,-17,0,1,3,240,257,0.85714
840,-24,0,1,3,784,808,0.85714
0,73,0,0,3,36,-37,0.14286
0,0,1,1,2,13,13,0.71429
840,43,0,1,1,843,800,0.57143
240,0,1,1,2,223,223,0.71429
0,36,0,0,2,40,4,0.28571
240,0,1,1,2,207,207,0.71429
840,-26,0,1,3,826,852,0.85714
240,0,1,1,2,239,239,0.71429
240,0,1,1,2,255,255,0.71429
240,54,0,0,3,294,240,0.14286
840,23,0,0,3,850,827,0.14286
240,0,1,0,2,251,251,0.28571
240,10,0,0,2,244,234,0.28571
0,-12,0,0,3,30,42,0.14286
480,-19,0,0,3,502,521,0.14286
0,0,1,1,2,6,6,0.71429
480,0,1,1,2,454,454,0.71429
240,-13,0,0,2,243,256,0.28571
0,0,1,1,2,-8,-8,0.71429
480,0,1,1,2,503,503,0.71429
840,0,1,1,2,809,809,0.71429
480,0,1,1,2,495,495,0.71429
0,30,0,0,3,-8,-38,0.14286
0,0,1,1,2,-9,-9,0.71429
480,-7,0,1,2,489,496,0.71429
480,0,1,1,2,462,462,0.71429
840,0,1,1,2,815,815,0.71429
480,-19,0,1,2,470,489,0.71429
480,0,1,1,3,462,462,0.85714
840,-30,0,1,4,820,850,1
240,0,1,1,3,207,207,0.85714
0,0,1,1,4,8,8,1
840,0,1,1,3,850,850,0.85714
0,0,1,1,3,0,0,0.85714
480,0,1,1,3,477,477,0.85714
240,34,0,1,3,270,236,0.85714
240,0,1,1,3,199,199,0.85714
480,0,1,1,3,490,490,0.85714
240,58,0,0,4,270,212,0
840,29,0,0,4,854,825,0
0,14,0,0,3,-3,-17,0.14286
480,-29,0,1,3,466,495,0.85714
840,0,1,1,3,834,834,0.85714
480,-11,0,1,3,456,467,0.85714
480,0,1,1,3,531,531,0.85714
480,-42,0,1,3,461,503,0.85714
840,0,1,1,2,869,869,0.71429
0,24,0,0,3,9,-15,0.14286
840,0,1,1,2,856,856,0.71429
840,0,1,1,2,879,879,0.71429
0,-1,0,1,2,29,30,0.71429
840,0,1,1,2,867,867,0.71429
240,21,0,0,4,260,239,0
840,0,1,1,2,830,830,0.71429
480,24,0,0,2,458,434,0.28571
840,0,1,0,2,853,853,0.28571
240,0,1,0,2,300,300,0.28571
0,0,1,1,2,21,21,0.71429
240,-58,0,0,3,187,245,0.14286
0,0,1,1,2,-13,-13,0.71429
480,48,0,0,4,510,462,0
0,24,0,0,3,9,-15,0.14286
480,0,1,1,2,486,486,0.71429
0,0,1,1,2,5,5,0.71429
840,-13,0,1,2,849,862,0.71429
480,82,0,0,4,536,454,0
840,-71,0,0,1,819,890,0.42857
840,39,0,1,1,893,854,0.57143
240,-7,0,1,2,234,241,0.71429
840,0,1,0,1,817,817,0.42857
840,23,0,1,1,860,837,0.57143
0,0,1,1,2,-27,-27,0.71429
840,0,1,1,3,822,822,0.85714
0,24,0,0,3,-1,-25,0.14286
840,0,1,0,2,802,802,0.28571
480,0,1,0,1,525,525,0.42857
0,26,0,0,3,15,-11,0.14286
0,0,1,0,3,16,16,0.14286
240,0,1,1,1,245,245,0.57143
840,-46,0,0,2,839,885,0.28571
840,0,1,0,3,828,828,0.14286
840,-10,0,0,2,833,843,0.28571
840,0,1,0,3,860,860,0.14286
0,-50,0,0,4,-33,17,0
0,59,0,0,4,10,-49,0
0,13,0,0,4,10,-3,0
480,-49,0,1,3,463,512,0.85714
480,28,0,0,3,500,472,0.14286
480,36,0,0,3,498,462,0.14286
840,27,0,1,2,842,815,0.71429
840,0,1,1,2,809,809,0.71429
840,39,0,0,2,845,806,0.28571
240,8,0,1,3,278,270,0.85714
840,48,0,1,3,891,843,0.85714
840,-2,0,1,3,819,821,0.85714
240,0,1,1,2,216,216,0.71429
480,0,1,1,3,518,518,0.85714
840,12,0,1,2,851,839,0.71429
240,0,1,1,2,262,262,0.71429
480,67,0,0,3,525,458,0.14286
480,26,0,1,2,483,457,0.71429
240,0,1,1,3,239,239,0.85714
480,-74,0,1,3,447,521,0.85714
0,0,1,0,2,40,40,0.28571
480,0,1,1,2,452,452,0.71429
0,0,1,0,2,-7,-7,0.28571
240,0,1,0,2,255,255,0.28571
0,0,1,0,2,-10,-10,0.28571
480,0,1,0,2,500,500,0.28571
0,0,1,0,2,45,45,0.28571
480,0,1,1,3,463,463,0.85714
0,0,1,1,3,25,25,0.85714
240,38,0,1,3,227,189,0.85714
240,0,1,1,2,234,234,0.71429
840,-5,0,0,1,858,863,0.42857
240,-42,0,0,4,225,267,0
840,-5,0,1,1,825,830,0.57143
0,-5,0,1,2,9,14,0.71429
240,0,1,1,2,269,269,0.71429
240,0,1,0,2,227,227,0.28571
480,-33,0,0,3,459,492,0.14286
240,0,1,0,2,266,266,0.28571
240,-24,0,1,2,258,282,0.71429
0,0,1,1,2,-25,-25,0.71429
840,-5,0,1,3,835,840,0.85714
840,31,0,1,3,843,812,0.85714
840,0,1,1,3,864,864,0.85714
840,-29,0,0,2,814,843,0.28571
840,0,1,1,1,813,813,0.57143
480,0,1,1,2,460,460,0.71429
0,0,1,1,2,-35,-35,0.71429
0,0,1,1,1,39,39,0.57143
840,-38,0,1,3,809,847,0.85714
480,2,0,1,3,471,469,0.85714
840,-12,0,1,2,842,854,0.71429
240,65,0,0,4,267,202,0
840,-1,0,0,3,826,827,0.14286
240,0,1,0,2,235,235,0.28571
0,14,0,0,2,5,-9,0.28571
840,0,1,0,3,868,868,0.14286
480,0,1,0,2,518,518,0.28571
240,0,1,0,2,229,229,0.28571
240,-16,0,0,2,226,242,0.28571
840,0,1,1,2,861,861,0.71429
840,0,1,1,2,857,857,0.71429
240,-10,0,1,2,247,257,0.71429
480,-3,0,1,2,485,488,0.71429
840,0,1,1,2,805,805,0.71429
240,0,1,1,3,257,257,0.85714
0,-8,0,0,2,-8,-0,0.28571
480,25,0,1,2,490,465,0.71429
0,0,1,1,2,26,26,0.71429
0,16,0,1,2,-8,-24,0.71429
0,0,1,1,2,29,29,0.71429
240,39,0,0,3,285,246,0.14286
840,-16,0,1,2,792,808,0.71429
240,0,1,0,2,216,216,0.28571
0,-7,0,0,3,24,31,0.14286
480,48,0,0,2,471,423,0.28571
0,0,1,0,2,7,7,0.28571
840,0,1,0,2,857,857,0.28571
480,0,1,1,2,470,470,0.71429
480,0,1,1,2,502,502,0.71429
240,0,1,0,2,214,214,0.28571
0,-49,0,0,2,-27,22,0.28571
240,45,0,0,2,253,208,0.28571
240,0,1,1,2,204,204,0.71429
0,-16,0,0,2,10,26,0.28571
0,6,0,1,2,-47,-53,0.71429
240,-30,0,0,2,215,245,0.28571
840,0,1,1,2,857,857,0.71429
0,24,0,0,2,-21,-45,0.28571
480,73,0,0,2,501,428,0.28571
0,0,1,1,2,-1,-1,0.71429
480,0,1,1,2,516,516,0.71429
0,0,1,1,2,50,50,0.71429
480,4,0,1,2,494,490,0.71429
480,37,0,1,3,519,482,0.85714
0,0,1,1,2,-1,-1,0.71429
480,0,1,1,2,496,496,0.71429
0,4,0,0,2,-1,-5,0.28571
0,-29,0,0,3,-10,19,0.14286
480,27,0,0,2,490,463,0.28571
840,-14,0,0,2,832,846,0.28571
0,-4,0,1,2,29,33,0.71429
480,0,1,1,2,482,482,0.71429
840,0,1,1,3,831,831,0.85714
240,0,1,1,2,228,228,0.71429
0,-29,0,0,3,-19,10,0.14286
840,0,1,1,2,850,850,0.71429
0,0,1,1,2,23,23,0.71429
240,0,1,1,2,244,244,0.71429
840,-42,0,1,3,813,855,0.85714
840,-21,0,1,2,846,867,0.71429
480,0,1,1,2,466,466,0.71429
240,38,0,0,3,256,218,0.14286
240,0,1,0,2,220,220,0.28571
240,-9,0,1,2,205,214,0.71429
0,-24,0,0,3,-21,3,0.14286
480,0,1,0,3,432,432,0.14286
480,-24,0,0,2,472,496,0.28571
240,0,1,1,2,259,259,0.71429
480,0,1,1,2,472,472,0.71429
480,-4,0,1,2,462,466,0.71429
0,0,1,1,2,16,16,0.71429
840,2,0,1,2,833,831,0.71429
840,0,1,1,3,839,839,0.85714
840,7,0,1,2,833,826,0.71429
480,0,1,1,2,485,485,0.71429
0,0,1,1,2,-27,-27,0.71429
840,-44,0,0,3,812,856,0.14286
240,-18,0,0,2,256,274,0.28571
0,-21,0,0,2,-59,-38,0.28571
240,0,1,1,2,269,269,0.71429
240,-24,0,0,2,245,269,0.28571
240,43,0,0,2,233,190,0.28571
480,0,1,1,2,514,514,0.71429
240,11,0,1,2,228,217,0.71429
0,0,1,0,2,-1,-1,0.28571
480,-9,0,0,2,476,485,0.28571
0,0,1,1,2,24,24,0.71429
480,-12,0,1,2,474,486,0.71429
840,0,1,1,2,840,840,0.71429
240,0,1,1,3,229,229,0.85714
0,-13,0,0,2,-11,2,0.28571
0,-34,0,0,2,-9,25,0.28571
480,-18,0,1,2,492,510,0.71429
0,50,0,0,3,49,-1,0.14286
0,0,1,0,2,-8,-8,0.28571
240,0,1,1,2,267,267,0.71429
240,0,1,0,2,256,256,0.28571
840,0,1,0,2,867,867,0.28571
480,48,0,0,2,526,478,0.28571
840,0,1,0,2,843,843,0.28571
480,-49,0,0,2,431,480,0.28571
0,61,0,0,2,37,-24,0.28571
0,0,1,0,2,7,7,0.28571
480,-42,0,0,2,474,516,0.28571
480,-6,0,0,2,470,476,0.28571
240,40,0,0,2,255,215,0.28571
0,0,1,0,2,33,33,0.28571
840,5,0,1,2,861,856,0.71429
480,0,1,1,2,509,509,0.71429
0,0,1,1,2,16,16,0.71429
240,0,1,1,3,227,227,0.85714
240,0,1,1,2,272,272,0.71429
480,2,0,1,2,480,478,0.71429
480,0,1,1,2,443,443,0.71429
840,-4,0,1,2,837,841,0.71429
840,17,0,1,2,830,813,0.71429
0,0,1,1,3,13,13,0.85714
240,35,0,0,3,251,216,0.14286
0,0,1,0,2,17,17,0.28571
240,-18,0,0,1,229,247,0.42857
480,0,1,1,2,481,481,0.71429
840,0,1,1,1,842,842,0.57143
480,0,1,1,1,468,468,0.57143
0,0,1,1,1,28,28,0.57143
480,0,1,1,2,535,535,0.71429
840,0,1,1,2,788,788,0.71429
240,20,0,1,2,281,261,0.71429
480,0,1,0,2,458,458,0.28571
240,-33,0,0,4,220,253,0
240,0,1,1,2,243,243,0.71429
240,-5,0,0,2,253,258,0.28571
240,0,1,0,2,217,217,0.28571
840,-17,0,1,1,840,857,0.57143
240,-13,0,0,2,220,233,0.28571
0,26,0,0,3,-11,-37,0.14286
840,39,0,1,1,857,818,0.57143
840,31,0,1,1,857,826,0.57143
240,22,0,1,2,267,245,0.71429
0,-48,0,0,4,-47,1,0
240,0,1,1,2,224,224,0.71429
480,0,1,1,1,443,443,0.57143
0,0,1,1,1,4,4,0.57143
0,0,1,1,2,44,44,0.71429
840,6,0,1,2,851,845,0.71429
0,0,1,1,2,18,18,0.71429
0,-13,0,0,3,-4,9,0.14286
840,0,1,1,2,869,869,0.71429
480,0,1,0,2,487,487,0.28571
240,18,0,0,3,265,247,0.14286
480,33,0,0,2,503,470,0.28571
240,0,1,1,2,229,229,0.71429
0,0,1,1,1,-34,-34,0.57143
0,0,1,1,1,-10,-10,0.57143
840,0,1,1,2,819,819,0.71429
840,-30,0,1,1,808,838,0.57143
480,-54,0,0,4,451,505,0
480,0,1,1,1,450,450,0.57143
480,21,0,1,1,498,477,0.57143
240,3,0,1,1,226,223,0.57143
480,0,1,1,1,467,467,0.57143
0,0,1,1,1,20,20,0.57143
0,0,1,1,1,-15,-15,0.57143
480,0,1,1,2,484,484,0.71429
840,-45,0,1,2,847,892,0.71429
240,0,1,1,2,251,251,0.71429
480,1,0,1,2,488,487,0.71429
240,0,1,1,2,233,233,0.71429
240,0,1,1,2,252,252,0.71429
840,14,0,1,2,867,853,0.71429
240,27,0,0,3,235,208,0.14286
240,0,1,1,2,217,217,0.71429
480,59,0,0,3,506,447,0.14286
0,36,0,0,3,-16,-52,0.14286
480,0,1,1,1,469,469,0.57143
0,-22,0,0,3,-31,-9,0.14286
480,0,1,1,1,445,445,0.57143
480,18,0,0,2,533,515,0.28571
480,16,0,1,1,475,459,0.57143
840,12,0,1,2,865,853,0.71429
0,0,1,1,1,-19,-19,0.57143
480,0,1,1,2,480,480,0.71429
0,2,0,1,1,3,1,0.57143
240,21,0,0,2,262,241,0.28571
240,0,1,1,1,238,238,0.57143
240,-17,0,1,1,231,248,0.57143
480,-33,0,0,3,423,456,0.14286
240,-14,0,1,1,219,233,0.57143
0,-36,0,0,3,38,74,0.14286
480,0,1,0,2,476,476,0.28571
840,-60,0,0,2,824,884,0.28571
840,-4,0,1,1,843,847,0.57143
240,0,1,1,1,246,246,0.57143
840,-63,0,1,1,834,897,0.57143
480,37,0,1,2,501,464,0.71429
840,-11,0,1,2,846,857,0.71429
240,0,1,0,1,248,248,0.42857
840,38,0,0,3,857,819,0.14286
840,31,0,0,3,806,775,0.14286
480,-18,0,1,2,489,507,0.71429
480,0,1,1,2,462,462,0.71429
240,0,1,1,2,279,279,0.71429
240,0,1,1,1,236,236,0.57143
480,-18,0,1,1,467,485,0.57143
480,0,1,0,2,483,483,0.28571
0,0,1,1,1,31,31,0.57143
240,0,1,1,1,251,251,0.57143
240,0,1,1,1,250,250,0.57143
0,0,1,1,2,37,37,0.71429
240,0,1,1,2,266,266,0.71429
480,0,1,1,2,498,498,0.71429
240,-38,0,0,3,203,241,0.14286
0,0,1,1,2,-15,-15,0.71429
840,-7,0,1,2,848,855,0.71429
480,6,0,1,2,438,432,0.71429
240,0,1,1,3,231,231,0.85714
840,-5,0,1,2,858,863,0.71429
840,-4,0,1,2,820,824,0.71429
480,0,1,1,2,478,478,0.71429
240,-5,0,0,2,272,277,0.28571
240,42,0,0,4,266,224,0
480,-23,0,0,2,461,484,0.28571
0,10,0,0,2,-23,-33,0.28571
0,14,0,0,1,22,8,0.42857
240,0,1,1,1,214,214,0.57143
240,-76,0,0,4,196,272,0
240,0,1,0,2,236,236,0.28571
240,-36,0,0,3,229,265,0.14286
240,0,1,0,2,220,220,0.28571
240,0,1,0,2,208,208,0.28571
840,37,0,0,3,849,812,0.14286
240,0,1,0,2,233,233,0.28571
480,0,1,0,2,471,471,0.28571
0,0,1,1,2,27,27,0.71429
0,-84,0,0,3,-59,25,0.14286
480,0,1,0,3,456,456,0.14286
240,-49,0,0,3,230,279,0.14286
840,0,1,1,2,852,852,0.71429
0,0,1,0,2,-24,-24,0.28571
480,0,1,1,1,478,478,0.57143
0,-32,0,0,3,-30,2,0.14286
240,0,1,1,1,238,238,0.57143
480,-21,0,1,1,460,481,0.57143
840,-29,0,1,1,819,848,0.57143
240,-43,0,0,3,236,279,0.14286
480,85,0,0,3,521,436,0.14286
0,0,1,1,1,-42,-42,0.57143
240,0,1,1,2,231,231,0.71429
0,0,1,1,2,3,3,0.71429
240,-5,0,1,2,253,258,0.71429
0,43,0,0,3,51,8,0.14286
240,-25,0,0,3,223,248,0.14286
840,4,0,0,1,853,849,0.42857
480,-39,0,0,2,468,507,0.28571
480,0,1,0,2,517,517,0.28571
480,17,0,0,2,480,463,0.28571
480,0,1,0,2,512,512,0.28571
840,0,1,0,3,851,851,0.14286
840,0,1,0,2,809,809,0.28571
840,-37,0,0,2,822,859,0.28571
840,-40,0,1,2,798,838,0.71429
0,0,1,1,1,4,4,0.57143
240,0,1,1,1,222,222,0.57143
480,10,0,1,1,486,476,0.57143
0,-21,0,0,2,2,23,0.28571
480,0,1,1,1,445,445,0.57143
480,0,1,1,2,506,506,0.71429
840,0,1,1,2,815,815,0.71429
240,0,1,1,1,244,244,0.57143
480,-16,0,1,2,477,493,0.71429
0,-9,0,0,2,-6,3,0.28571
840,0,1,0,1,823,823,0.42857
0,0,1,0,1,11,11,0.42857
480,0,1,1,2,462,462,0.71429
240,0,1,1,1,245,245,0.57143
0,0,1,1,1,30,30,0.57143
840,0,1,1,1,829,829,0.57143
0,0,1,1,1,-24,-24,0.57143
0,-50,0,0,4,-22,28,0
240,0,1,1,1,228,228,0.57143
0,9,0,0,2,-17,-26,0.28571
240,0,1,1,1,188,188,0.57143
240,-26,0,0,2,230,256,0.28571
840,21,0,1,1,856,835,0.57143
0,0,1,1,1,-11,-11,0.57143
840,0,1,1,1,875,875,0.57143
480,0,1,1,1,497,497,0.57143
840,-3,0,1,1,842,845,0.57143
0,-37,0,0,4,-9,28,0
240,0,1,1,1,247,247,0.57143
240,-33,0,0,3,212,245,0.14286
840,28,0,1,1,865,837,0.57143
240,19,0,0,4,232,213,0
0,0,1,1,1,-6,-6,0.57143
840,107,0,0,4,903,796,0
480,-40,0,0,2,470,510,0.28571
0,0,1,1,1,2,2,0.57143
840,0,1,1,2,803,803,0.71429
0,0,1,1,2,1,1,0.71429
0,-33,0,0,3,-23,10,0.14286
840,-11,0,1,1,809,820,0.57143
840,0,1,0,2,847,847,0.28571
840,-21,0,1,1,821,842,0.57143
840,0,1,1,1,842,842,0.57143
0,-28,0,0,2,-37,-9,0.28571
240,47,0,0,3,275,228,0.14286
480,0,1,0,2,508,508,0.28571
480,0,1,1,1,477,477,0.57143
0,-25,0,0,3,-21,4,0.14286
0,0,1,0,2,18,18,0.28571
0,0,1,1,1,39,39,0.57143
840,0,1,1,1,816,816,0.57143
840,-11,0,1,1,828,839,0.57143
0,-50,0,0,4,-14,36,0
840,4,0,1,1,841,837,0.57143
480,-64,0,0,3,427,491,0.14286
0,-13,0,0,2,13,26,0.28571
0,-17,0,0,2,18,35,0.28571
480,0,1,1,1,506,506,0.57143
840,45,0,1,1,856,811,0.57143
480,0,1,1,1,480,480,0.57143
0,0,1,1,1,-10,-10,0.57143
480,0,1,1,1,490,490,0.57143
240,61,0,0,3,260,199,0.14286
240,0,1,1,1,229,229,0.57143
840,0,1,1,2,835,835,0.71429
0,36,0,0,3,-15,-51,0.14286
240,0,1,1,2,227,227,0.71429
240,10,0,1,1,279,269,0.57143
840,55,0,1,2,882,827,0.71429
840,0,1,1,2,852,852,0.71429
0,0,1,1,2,-2,-2,0.71429
480,14,0,1,2,491,477,0.71429
240,0,1,1,2,274,274,0.71429
480,8,0,1,2,467,459,0.71429
0,0,1,1,1,-17,-17,0.57143
0,0,1,1,1,30,30,0.57143
240,-28,0,1,1,231,259,0.57143
840,0,1,1,2,858,858,0.71429
480,0,1,1,2,470,470,0.71429
240,11,0,1,2,246,235,0.71429
480,34,0,1,2,491,457,0.71429
480,0,1,1,1,510,510,0.57143
840,-13,0,1,2,854,867,0.71429
840,34,0,0,2,867,833,0.28571
480,0,1,1,1,489,489,0.57143
840,0,1,1,2,852,852,0.71429
240,30,0,0,4,247,217,0
480,0,1,1,2,473,473,0.71429
480,-18,0,1,2,454,472,0.71429
240,-84,0,0,4,194,278,0
240,0,1,1,1,272,272,0.57143
480,36,0,0,2,503,467,0.28571
840,0,1,1,2,866,866,0.71429
480,0,1,0,3,444,444,0.14286
0,0,1,1,1,-33,-33,0.57143
240,0,1,1,1,204,204,0.57143
840,53,0,1,2,832,779,0.71429
840,0,1,1,2,846,846,0.71429
0,0,1,1,2,80,80,0.71429
840,0,1,1,2,829,829,0.71429
240,31,0,0,3,248,217,0.14286
240,0,1,0,2,252,252,0.28571
0,-3,0,0,1,-17,-14,0.42857
240,0,1,0,1,225,225,0.42857
840,-35,0,1,1,829,864,0.57143
480,0,1,1,1,492,492,0.57143
0,0,1,1,1,11,11,0.57143
0,-20,0,0,2,-4,16,0.28571
240,0,1,1,2,251,251,0.71429
840,0,1,1,1,815,815,0.57143
0,23,0,0,2,6,-17,0.28571
0,13,0,0,2,-1,-14,0.28571
0,-54,0,0,2,5,59,0.28571
480,25,0,1,1,507,482,0.57143
0,0,1,1,1,-20,-20,0.57143
840,0,1,1,1,896,896,0.57143
0,-21,0,0,2,-2,19,0.28571
240,14,0,0,2,252,238,0.28571
0,-55,0,0,3,-43,12,0.14286
840,-37,0,0,2,818,855,0.28571
480,0,1,0,2,488,488,0.28571
240,18,0,0,3,239,221,0.14286
840,0,1,1,1,835,835,0.57143
480,-48,0,0,3,486,534,0.14286
0,0,1,0,2,-35,-35,0.28571
480,0,1,0,2,478,478,0.28571
0,27,0,0,3,36,9,0.14286
0,4,0,0,1,11,7,0.42857
240,0,1,0,2,208,208,0.28571
480,0,1,1,1,461,461,0.57143
240,1,0,1,2,252,251,0.71429
0,-43,0,0,4,-38,5,0
840,-13,0,1,1,845,858,0.57143
480,-41,0,0,3,466,507,0.14286
0,0,1,1,1,2,2,0.57143
840,0,1,1,2,833,833,0.71429
480,0,1,1,2,499,499,0.71429
480,-5,0,1,1,489,494,0.57143
480,0,1,1,1,495,495,0.57143
840,-2,0,0,2,867,869,0.28571
840,7,0,0,2,856,849,0.28571
480,-58,0,0,3,476,534,0.14286
0,56,0,0,3,51,-5,0.14286
240,-63,0,0,3,224,287,0.14286
240,0,1,0,2,212,212,0.28571
0,-12,0,0,2,16,28,0.28571
480,0,1,1,1,470,470,0.57143
840,0,1,1,2,855,855,0.71429
480,58,0,0,3,489,431,0.14286
240,-60,0,0,3,217,277,0.14286
240,0,1,1,1,254,254,0.57143
480,52,0,0,2,479,427,0.28571
840,49,0,0,2,855,806,0.28571
240,0,1,0,2,201,201,0.28571
0,0,1,1,1,-1,-1,0.57143
480,-23,0,0,2,432,455,0.28571
240,0,1,1,1,198,198,0.57143
480,0,1,1,2,485,485,0.71429
0,0,1,1,1,-35,-35,0.57143
240,-6,0,1,1,227,233,0.57143
0,0,1,1,1,17,17,0.57143
480,19,0,1,1,515,496,0.57143
840,0,1,1,2,864,864,0.71429
240,-24,0,1,1,214,238,0.57143
480,-12,0,1,2,482,494,0.71429
840,-16,0,1,1,839,855,0.57143
0,0,1,1,1,-22,-22,0.57143
0,0,1,1,1,-11,-11,0.57143
840,34,0,0,2,846,812,0.28571
480,59,0,0,2,508,449,0.28571
0,0,1,1,1,-1,-1,0.57143
240,-17,0,1,1,228,245,0.57143
840,0,1,1,2,850,850,0.71429
0,0,1,1,1,-22,-22,0.57143
0,-10,0,0,2,-1,9,0.28571
240,0,1,0,2,236,236,0.28571
480,-4,0,0,1,465,469,0.42857
480,0,1,1,1,475,475,0.57143
480,-22,0,1,2,499,521,0.71429
840,-16,0,1,1,831,847,0.57143
840,0,1,0,2,847,847,0.28571
0,-34,0,0,2,-0,34,0.28571
240,-19,0,0,1,230,249,0.42857
480,32,0,1,1,481,449,0.57143
480,-2,0,1,1,485,487,0.57143
840,0,1,1,1,827,827,0.57143
0,-39,0,0,2,6,45,0.28571
480,-8,0,0,2,477,485,0.28571
0,0,1,1,1,-9,-9,0.57143
0,0,1,1,1,-10,-10,0.57143
240,0,1,1,1,232,232,0.57143
480,0,1,1,1,464,464,0.57143
240,0,1,1,1,248,248,0.57143
480,0,1,1,1,494,494,0.57143
0,35,0,0,3,29,-6,0.14286
840,0,1,1,2,874,874,0.71429
840,0,1,1,1,823,823,0.57143
840,0,1,0,3,787,787,0.14286
840,0,1,1,2,843,843,0.71429
240,0,1,1,2,224,224,0.71429
840,-38,0,0,2,827,865,0.28571
840,0,1,0,2,846,846,0.28571
480,0,1,1,2,460,460,0.71429
840,0,1,1,2,844,844,0.71429
840,-86,0,0,3,803,889,0.14286
480,0,1,0,2,472,472,0.28571
0,26,0,0,2,37,11,0.28571
0,0,1,0,2,-1,-1,0.28571
480,0,1,0,2,487,487,0.28571
0,0,1,1,1,-13,-13,0.57143
480,-5,0,1,2,490,495,0.71429
840,58,0,0,2,851,793,0.28571
840,-50,0,0,2,806,856,0.28571
240,38,0,0,2,241,203,0.28571
240,-24,0,0,2,200,224,0.28571
240,0,1,1,1,235,235,0.57143
840,0,1,1,1,835,835,0.57143
480,0,1,1,1,467,467,0.57143
480,11,0,1,1,488,477,0.57143
840,0,1,1,1,875,875,0.57143
240,0,1,1,1,275,275,0.57143
480,0,1,1,1,497,497,0.57143
0,8,0,1,1,-1,-9,0.57143
480,26,0,1,1,479,453,0.57143
840,22,0,1,2,850,828,0.71429
240,0,1,1,1,237,237,0.57143
240,-7,0,1,1,228,235,0.57143
840,-12,0,1,1,836,848,0.57143
240,-10,0,1,1,256,266,0.57143
0,0,1,1,1,16,16,0.57143
0,43,0,0,3,22,-21,0.14286
840,0,1,0,2,846,846,0.28571
0,-32,0,0,2,-13,19,0.28571
240,-8,0,1,1,234,242,0.57143
840,44,0,1,2,871,827,0.71429
0,15,0,0,1,11,-4,0.42857
480,0,1,0,1,506,506,0.42857
0,-11,0,0,2,29,40,0.28571
240,29,0,0,3,265,236,0.14286
480,11,0,1,1,491,480,0.57143
840,102,0,0,3,900,798,0.14286
0,0,1,1,1,35,35,0.57143
240,0,1,1,1,249,249,0.57143
0,0,1,0,2,0,0,0.28571
480,-33,0,0,2,474,507,0.28571
240,0,1,0,3,243,243,0.14286
480,-31,0,0,3,463,494,0.14286
240,0,1,0,2,176,176,0.28571
0,25,0,0,2,-10,-35,0.28571
480,10,0,0,1,477,467,0.42857
240,-46,0,0,2,199,245,0.28571
0,0,1,1,2,-10,-10,0.71429
480,0,1,1,2,488,488,0.71429
240,0,1,1,2,248,248,0.71429
840,0,1,1,2,825,825,0.71429
480,0,1,1,2,450,450,0.71429
480,-38,0,1,1,491,529,0.57143
840,-6,0,1,1,824,830,0.57143
840,0,1,1,1,793,793,0.57143
480,-30,0,0,2,466,496,0.28571
0,-29,0,0,3,15,44,0.14286
240,18,0,0,4,263,245,0
0,40,0,0,3,36,-4,0.14286
480,0,1,0,3,452,452,0.14286
840,76,0,0,3,874,798,0.14286
840,0,1,0,3,838,838,0.14286
0,-25,0,0,3,-4,21,0.14286
840,-8,0,0,3,823,831,0.14286
0,0,1,0,1,-19,-19,0.42857
840,36,0,0,3,862,826,0.14286
0,6,0,0,3,-10,-16,0.14286
480,10,0,0,2,520,510,0.28571
840,0,1,0,2,871,871,0.28571
240,5,0,1,1,242,237,0.57143
840,-21,0,1,2,819,840,0.71429
0,19,0,0,2,16,-3,0.28571
0,0,1,0,2,-25,-25,0.28571
240,38,0,0,2,260,222,0.28571
840,0,1,0,2,870,870,0.28571
840,0,1,1,1,827,827,0.57143
840,0,1,1,2,839,839,0.71429
0,0,1,1,1,-37,-37,0.57143
840,19,0,0,2,872,853,0.28571
480,45,0,0,2,499,454,0.28571
840,-1,0,0,2,799,800,0.28571
840,0,1,0,2,889,889,0.28571
0,17,0,0,2,6,-11,0.28571
840,18,0,1,2,853,835,0.71429
840,47,0,0,2,858,811,0.28571
480,8,0,0,2,472,464,0.28571
480,-20,0,0,2,486,506,0.28571
480,0,1,0,2,435,435,0.28571
240,26,0,1,1,274,248,0.57143
240,0,1,1,1,283,283,0.57143
480,-6,0,1,2,507,513,0.71429
240,0,1,1,2,215,215,0.71429
0,9,0,1,1,35,26,0.57143
840,0,1,1,2,777,777,0.71429
480,0,1,1,2,500,500,0.71429
480,0,1,1,2,496,496,0.71429
0,0,1,1,1,-20,-20,0.57143
840,36,0,1,2,839,803,0.71429
0,46,0,0,3,40,-6,0.14286
0,0,1,1,1,-22,-22,0.57143
480,8,0,1,2,501,493,0.71429
840,0,1,1,2,851,851,0.71429
480,0,1,0,2,462,462,0.28571
240,38,0,0,2,251,213,0.28571
0,0,1,1,1,-33,-33,0.57143
240,55,0,0,3,275,220,0.14286
840,0,1,0,3,810,810,0.14286
240,0,1,1,2,212,212,0.71429
840,18,0,1,2,847,829,0.71429
0,0,1,1,1,7,7,0.57143
240,50,0,0,4,272,222,0
240,0,1,0,3,251,251,0.14286
480,0,1,1,1,488,488,0.57143
240,0,1,1,2,218,218,0.71429
480,0,1,1,2,517,517,0.71429
0,0,1,1,1,-4,-4,0.57143
840,0,1,1,2,821,821,0.71429
480,0,1,1,2,493,493,0.71429
0,48,0,0,3,35,-13,0.14286
240,0,1,1,2,227,227,0.71429
0,32,0,0,3,9,-23,0.14286
0,0,1,0,1,24,24,0.42857
840,0,1,1,1,820,820,0.57143
240,64,0,0,3,252,188,0.14286
480,0,1,0,1,483,483,0.42857
0,0,1,1,2,11,11,0.71429
840,0,1,1,1,856,856,0.57143
0,-7,0,1,1,-8,-1,0.57143
0,9,0,1,1,-16,-25,0.57143
840,-1,0,1,2,823,824,0.71429
480,-51,0,0,4,436,487,0
240,0,1,0,2,221,221,0.28571
240,0,1,0,2,277,277,0.28571
840,21,0,1,2,855,834,0.71429
0,0,1,1,2,-47,-47,0.71429
840,9,0,1,1,825,816,0.57143
240,0,1,1,2,204,204,0.71429
840,0,1,1,1,857,857,0.57143
480,0,1,1,1,454,454,0.57143
480,0,1,1,1,452,452,0.57143
480,0,1,1,2,468,468,0.71429
840,24,0,1,2,863,839,0.71429
0,0,1,1,1,4,4,0.57143
0,-14,0,0,2,-9,5,0.28571
240,-44,0,0,3,203,247,0.14286
0,17,0,0,2,-9,-26,0.28571
0,0,1,1,1,-16,-16,0.57143
480,0,1,1,1,466,466,0.57143
840,0,1,0,2,846,846,0.28571
0,63,0,0,3,40,-23,0.14286
840,0,1,0,2,826,826,0.28571
240,-53,0,0,4,233,286,0
240,0,1,0,2,232,232,0.28571
240,16,0,0,2,236,220,0.28571
240,0,1,0,3,218,218,0.14286
240,0,1,0,2,193,193,0.28571
240,0,1,0,2,209,209,0.28571
480,10,0,1,2,484,474,0.71429
0,10,0,1,2,-6,-16,0.71429
480,-35,0,0,3,442,477,0.14286
840,0,1,0,2,838,838,0.28571
480,0,1,0,4,463,463,0
480,0,1,0,2,497,497,0.28571
480,-70,0,0,3,406,476,0.14286
240,0,1,1,2,211,211,0.71429
840,0,1,1,2,851,851,0.71429
480,-18,0,1,2,448,466,0.71429
0,0,1,1,2,-11,-11,0.71429
840,0,1,1,2,852,852,0.71429
840,0,1,1,2,785,785,0.71429
480,0,1,1,2,488,488,0.71429
240,-23,0,0,2,235,258,0.28571
0,0,1,0,2,-38,-38,0.28571
240,0,1,0,2,278,278,0.28571
480,0,1,1,2,449,449,0.71429
0,0,1,1,1,-7,-7,0.57143
480,65,0,0,3,508,443,0.14286
840,-25,0,0,2,831,856,0.28571
0,17,0,0,2,31,14,0.28571
240,0,1,1,1,262,262,0.57143
840,0,1,1,1,862,862,0.57143
240,-4,0,1,1,241,245,0.57143
840,0,1,1,2,851,851,0.71429
0,-67,0,0,3,-36,31,0.14286
480,0,1,1,2,453,453,0.71429
480,0,1,1,2,474,474,0.71429
840,-15,0,1,2,819,834,0.71429
840,0,1,1,2,830,830,0.71429
480,0,1,1,2,445,445,0.71429
240,13,0,1,2,225,212,0.71429
480,24,0,1,2,466,442,0.71429
840,15,0,1,2,859,844,0.71429
240,0,1,1,2,205,205,0.71429
240,0,1,1,2,230,230,0.71429
840,18,0,1,2,858,840,0.71429
240,2,0,1,1,237,235,0.57143
0,0,1,1,3,1,1,0.85714
0,0,1,1,2,12,12,0.71429
840,0,1,1,2,882,882,0.71429
0,-19,0,0,3,-8,11,0.14286
840,0,1,0,2,848,848,0.28571
240,-52,0,0,3,214,266,0.14286
0,12,0,0,2,-5,-17,0.28571
840,0,1,0,2,849,849,0.28571
480,-36,0,0,3,435,471,0.14286
240,0,1,1,1,258,258,0.57143
240,48,0,0,3,273,225,0.14286
840,-16,0,0,4,820,836,0
0,-7,0,0,2,23,30,0.28571
0,22,0,0,3,28,6,0.14286
240,0,1,1,1,199,199,0.57143
0,-50,0,0,2,-23,27,0.28571
840,0,1,1,2,832,832,0.71429
0,0,1,1,1,-23,-23,0.57143
0,13,0,0,2,12,-1,0.28571
0,0,1,1,2,-28,-28,0.71429
240,-19,0,0,2,234,253,0.28571
840,-19,0,1,2,826,845,0.71429
0,24,0,0,2,2,-22,0.28571
480,71,0,1,2,499,428,0.71429
480,0,1,0,2,508,508,0.28571
0,79,0,0,3,31,-48,0.14286
240,30,0,0,4,259,229,0
840,14,0,0,3,855,841,0.14286
840,-9,0,0,2,831,840,0.28571
480,0,1,1,1,487,487,0.57143
840,23,0,0,3,851,828,0.14286
480,0,1,0,2,467,467,0.28571
480,1,0,0,3,470,469,0.14286
0,0,1,0,1,47,47,0.42857
0,0,1,0,1,32,32,0.42857
840,-69,0,1,1,829,898,0.57143
840,0,1,1,1,819,819,0.57143
0,0,1,1,1,27,27,0.57143
840,-10,0,1,1,840,850,0.57143
240,0,1,1,2,247,247,0.71429
240,0,1,1,1,256,256,0.57143
240,0,1,1,2,246,246,0.71429
480,-78,0,0,3,472,550,0.14286
840,0,1,1,2,856,856,0.71429
480,2,0,1,2,472,470,0.71429
480,0,1,1,1,522,522,0.57143
240,12,0,0,2,232,220,0.28571
240,-49,0,0,3,227,276,0.14286
240,-41,0,0,2,203,244,0.28571
